S.N.,Candidate,Party,EVM Votes,Postal Votes,Total Votes,% of Votes,Constituency
1,ARUNA,Indian National Congress,6724,58,6782,3.88,1
2,RAJ KARAN KHATRI,Bharatiya Janata Party,86463,752,87215,49.91,1
3,SHARAD KUMAR,Aam Aadmi Party,78395,224,78619,44.99,1
4,ANIL KUMAR SINGH,Communist Party of India  (Marxist-Leninist)  (Liberation),328,0,328,0.19,1
5,MD KHALID,Aazad Samaj Party (Kanshi Ram),278,0,278,0.16,1
6,BUDIYA,Independent,242,0,242,0.14,1
7,VIKAS BHARDWAJ,Independent,300,1,301,0.17,1
8,NOTA,None of the Above,973,8,981,0.56,1
1,GANGA RAM,Bahujan Samaj Party,2193,21,2214,0.87,2
2,MANGESH TYAGI,Indian National Congress,19808,112,19920,7.82,2
3,SANJEEV JHA,Aam Aadmi Party,120813,368,121181,47.57,2
4,ANIL KAPOOR,Janhit Dal,866,3,869,0.34,2
5,ABHISHEK KUMAR SINGH (MASTER JI),Rashtriya Janshakti Party (Secular),530,1,531,0.21,2
6,GULAB SINGHAL,Bhim Sena,318,0,318,0.12,2
7,DHURVA KUMAR,Right to Recall Party,224,0,224,0.09,2
8,PRAMOD,Sarvodaya Prabhat Party,315,0,315,0.12,2
9,MUKESH PRASAD,Bhartiya Janta Dal (Integrated),284,4,288,0.11,2
10,RATAN TYAGI,Nationalist Congress Party,3829,23,3852,1.51,2
11,VIJAY KUMAR JHA,Rachnatmak Jan Morcha,589,0,589,0.23,2
12,SHAILENDRA KUMAR,Janata Dal  (United),99943,637,100580,39.48,2
13,SUNIL KUMAR VYATHIT,Aam Aadmi Sangharsh Party (S),568,1,569,0.22,2
14,SONU KAUSHIK,Aapki Apni Party (Peoples),738,1,739,0.29,2
15,NOTA,None of the Above,2530,18,2548,1,2
1,LOKENDRA KALYAN SINGH,Indian National Congress,8313,48,8361,6.88,3
2,SURINDER PAL SINGH (BITTOO),Aam Aadmi Party,54602,171,54773,45.07,3
3,SURENDER PAL,Bahujan Samaj Party,976,9,985,0.81,3
4,SURYA PRAKASH KHATRI,Bharatiya Janata Party,55626,315,55941,46.03,3
5,TARUN KUMAR,Republican Sena,165,2,167,0.14,3
6,DEEPAK CHAWLA,Republican Party of India (Athawale),113,0,113,0.09,3
7,BIJENDER KUMAR,Jan Samuh Party,49,1,50,0.04,3
8,RAKESH RANJAN SHRIVASTAV,Janhit Dal,90,1,91,0.07,3
9,RAJKUMAR BHARTI,Peoples Party of India (Democratic),111,1,112,0.09,3
10,RAM RAJ SINGH,Rashtriya Janshakti Party (Secular),109,0,109,0.09,3
11,WASIM AKRAM,Indian National Socialistic Action Forces,69,0,69,0.06,3
12,SANGH PRIYA SIDDHARTHA,Bhim Sena,107,0,107,0.09,3
13,NOTA,None of the Above,658,5,663,0.55,3
1,ABDUL ZABBAR,Bahujan Samaj Party,343,1,344,0.34,4
2,MUKESH KUMAR GOEL,Aam Aadmi Party,40941,87,41028,40.84,4
3,RAJ KUMAR BHATIA,Bharatiya Janata Party,52260,250,52510,52.27,4
4,SHIVANK SINGAL,Indian National Congress,5442,18,5460,5.43,4
5,PRIYA,"Aam Janmat Party,",56,0,56,0.06,4
6,PREM CHAND,Rashtrawadi Janlok Party (Satya),41,0,41,0.04,4
7,MD: RAHMAT ALI,Navarang Congress Party,18,0,18,0.02,4
8,VISHAL SINGH,National Youth Party,27,0,27,0.03,4
9,SANJAY YADAV ADVOCATE,Peoples Party of India (Democratic),35,0,35,0.03,4
10,SANJEEV KUMAR RANA,Communist Party of India,133,0,133,0.13,4
11,AYUSH GUPTA,Independent,64,0,64,0.06,4
12,NEETU SINGH,Independent,111,0,111,0.11,4
13,RAM NIWAS,Independent,140,0,140,0.14,4
14,VIJAY KR. AGGARWAL,Independent,116,0,116,0.12,4
15,NOTA,None of the Above,374,3,377,0.38,4
1,AJESH YADAV,Aam Aadmi Party,45937,92,46029,30.51,5
2,AAHIR DEEPAK CHAUDHARYY,Bharatiya Janata Party,61011,181,61192,40.56,5
3,DEVENDER YADAV,Indian National Congress,40980,91,41071,27.22,5
4,RAVINDER KUMAR,Bahujan Samaj Party,723,2,725,0.48,5
5,GOPAL KUMAR SINHA,Bharatiya Sampuran Krantikari Party,76,0,76,0.05,5
6,PARMOD KUMAR,Socialist Unity Centre Of India (COMMUNIST),250,0,250,0.17,5
7,MULAYAM SINGH,Nationalist Congress Party,92,0,92,0.06,5
8,RAJENDER,"Aam Janmat Party,",68,0,68,0.05,5
9,R. C. SHARMA,Sarvodaya Prabhat Party,64,0,64,0.04,5
10,ARUN KUMAR,Independent,158,0,158,0.1,5
11,JAI PAL,Independent,214,0,214,0.14,5
12,DEVENDER KUMAR YADAV,Independent,235,0,235,0.16,5
13,NOTA,None of the Above,687,5,692,0.46,5
1,KULWANT RANA,Bharatiya Janata Party,103950,421,104371,55.76,6
2,NEYAZ KHAN,Bahujan Samaj Party,615,4,619,0.33,6
3,MOHINDER GOYAL,Aam Aadmi Party,74591,164,74755,39.94,6
4,SUSHANT MISHRA,Indian National Congress,5216,42,5258,2.81,6
5,ASHOK JAIN,Yuva Bharat Rashtraseva Party,213,0,213,0.11,6
6,AYASHA KHATOON,Peoples Party of India (Democratic),114,0,114,0.06,6
7,JITANDER SINGH,Asankhya Samaj Party,55,1,56,0.03,6
8,NISHTHA,Jai Maha Bharath Party,154,1,155,0.08,6
9,AJAY KUMAR SINGH,Independent,104,0,104,0.06,6
10,VIDYA PATTI,Independent,167,0,167,0.09,6
11,VISHAL GUPTA,Independent,117,0,117,0.06,6
12,NOTA,None of the Above,1224,11,1235,0.66,6
1,JAI BHAGWAN UPKAR,Aam Aadmi Party,87874,166,88040,38.3,7
2,RAVINDER INDRAJ SINGH,Bharatiya Janata Party,118746,769,119515,52,7
3,SURENDER KUMAR,Indian National Congress,18630,83,18713,8.14,7
4,HEERA LAL,Bahujan Samaj Party,1552,5,1557,0.68,7
5,DHEERAJ KUMAR,Peoples Party of India (Democratic),216,0,216,0.09,7
6,BABITA,Asankhya Samaj Party,188,2,190,0.08,7
7,HARI KISHAN MECHANIC,Independent,278,1,279,0.12,7
8,NOTA,None of the Above,1339,7,1346,0.59,7
1,GAJENDER DRALL,Bharatiya Janata Party,89128,711,89839,47.07,8
2,JASBIR KARALA,Aam Aadmi Party,79062,227,79289,41.54,8
3,DHARAMPAL LAKRA,Indian National Congress,10241,49,10290,5.39,8
4,SUMAN LATA SEHRAWAT,Bahujan Samaj Party,544,4,548,0.29,8
5,MAHAVIR,All India Forward Bloc,93,1,94,0.05,8
6,YOGENDER SINGH ALIAS YOGI MATHUR,Akhil Bharatiya Socialist Party,86,1,87,0.05,8
7,SUNIL KUMAR,National Loktantrik Party,165,1,166,0.09,8
8,SANJAYA KUMAR YADAV,Right to Recall Party,61,0,61,0.03,8
9,SANTOSH,Indian National Socialistic Action Forces,84,0,84,0.04,8
10,ANDEEP DRALL,Independent,112,3,115,0.06,8
11,RAJNI,Independent,128,1,129,0.07,8
12,RAMBIR SHOKEEN,Independent,8621,34,8655,4.53,8
13,SUNITA SHEKHAR CHAWARIYA,Independent,408,0,408,0.21,8
14,NOTA,None of the Above,1076,12,1088,0.57,8
1,ANIL JHA,Aam Aadmi Party,105660,120,105780,52.26,9
2,JUGBIR SINGH,Bahujan Samaj Party,2116,12,2128,1.05,9
3,BAJRANG SHUKLA,Bharatiya Janata Party,83749,160,83909,41.45,9
4,RAJESH KUMAR GUPTA,Indian National Congress,6847,17,6864,3.39,9
5,AFSANA SARWAR,Peace Party,208,0,208,0.1,9
6,MALIK NEYAZ AHMAD,Aazad Samaj Party (Kanshi Ram),885,0,885,0.44,9
7,SUDESH SHARMA,Rashtriya Manav Party,212,0,212,0.1,9
8,PRAKASH SRIVASTAV,Independent,588,0,588,0.29,9
9,RAKESH,Independent,472,1,473,0.23,9
10,NOTA,None of the Above,1363,3,1366,0.67,9
1,KARAM SINGH KARMA,Bharatiya Janata Party,41549,92,41641,36.91,10
2,KULWANT RANA,Bahujan Samaj Party,1882,3,1885,1.67,10
3,JAI KISHAN,Indian National Congress,8671,17,8688,7.7,10
4,MUKESH KUMAR AHLAWAT,Aam Aadmi Party,58687,80,58767,52.09,10
5,KARAN SINGH,Swaraj Bhartiya Nyay Party,151,0,151,0.13,10
6,JITENDER,Jai Maha Bharath Party,555,0,555,0.49,10
7,PREETI,Yuva Bharat Rashtraseva Party,82,0,82,0.07,10
8,BABU LAL,Bharatiya Sampuran Krantikari Party,91,0,91,0.08,10
9,LAXMI,Republican Party of India (Athawale),70,0,70,0.06,10
10,SANGEETA,Rashtriya Lok Sevak Party,72,0,72,0.06,10
11,DEEPAK KUMAR,Independent,177,0,177,0.16,10
12,RAMSWAROOP SAMRIA,Independent,150,2,152,0.13,10
13,NOTA,None of the Above,488,6,494,0.44,10
1,MANOJ KUMAR SHOKEEN,Bharatiya Janata Party,74950,322,75272,47.25,11
2,MUKESH KUMAR,Bahujan Samaj Party,792,3,795,0.5,11
3,RAGHUVINDER SHOKEEN,Aam Aadmi Party,48907,114,49021,30.77,11
4,ROHIT CHOUDHARY,Indian National Congress,31918,110,32028,20.1,11
5,KANCHAN SHARMA,Rashtriya Manav Party,162,0,162,0.1,11
6,MAHENDER SINGH RATHOR,Rashtriya Lok Sevak Party,152,0,152,0.1,11
7,YATENDER SHARMA,Azad Adhikar Sena,389,1,390,0.24,11
8,RAM SAJIVAN,Peoples Party of India (Democratic),204,1,205,0.13,11
9,DILIP KUMAR SHARMA,Independent,373,0,373,0.23,11
10,NOTA,None of the Above,915,9,924,0.58,11
1,DHARAM RAKSHAK ALIAS RAKESH JATAV,Aam Aadmi Party,55659,93,55752,45.16,12
2,MUKESH KUMAR,Bahujan Samaj Party,721,3,724,0.59,12
3,RAJ KUMAR CHAUHAN,Bharatiya Janata Party,61805,202,62007,50.23,12
4,HANUMAN SAHAY ALIAS HANUMAN CHAUHAN,Indian National Congress,3761,23,3784,3.07,12
5,KHILKHILAKAR,Bahujan Shoshit Samaj Sangharsh Samta Party,171,0,171,0.14,12
6,JAI BHAGWAN,Independent,250,0,250,0.2,12
7,NOTA,None of the Above,760,2,762,0.62,12
1,PARDEEP MITTAL,Aam Aadmi Party,32442,107,32549,30.07,13
2,VIJENDER GUPTA,Bharatiya Janata Party,69890,475,70365,65.01,13
3,SUMESH GUPTA,Indian National Congress,3721,44,3765,3.48,13
4,HARSHAD CHADHA,Bahujan Samaj Party,194,3,197,0.18,13
5,ABHISHEK,Jai Maha Bharath Party,118,0,118,0.11,13
6,AMIT SAINI,Jan Samuh Party,91,1,92,0.09,13
7,NARENDER SINGH PANWAR,Independent,52,2,54,0.05,13
8,RAJBIR,Independent,62,0,62,0.06,13
9,NOTA,None of the Above,1027,4,1031,0.95,13
1,PARVEEN KUMAR JAIN,Indian National Congress,4845,47,4892,4.3,14
2,BANDANA KUMARI,Aam Aadmi Party,38487,118,38605,33.93,14
3,REKHA GUPTA,Bharatiya Janata Party,67839,361,68200,59.95,14
4,SHYAM KUMAR,Bahujan Samaj Party,410,1,411,0.36,14
5,RANJEET VERMA,New India United Party,35,0,35,0.03,14
6,MOHD. USMAN,Independent,98,0,98,0.09,14
7,RAJESH KUMAR,Independent,143,0,143,0.13,14
8,RINA DEVI,Independent,252,0,252,0.22,14
9,SAURABH GUPTA,Independent,356,2,358,0.31,14
10,NOTA,None of the Above,768,2,770,0.68,14
1,KARNAIL SINGH,Bharatiya Janata Party,56570,299,56869,57.07,15
2,SATISH KUMAR LUTHRA,Indian National Congress,5736,48,5784,5.8,15
3,SATYENDAR JAIN,Aam Aadmi Party,35775,96,35871,36,15
4,VIJAY KUMAR,Bahujan Samaj Party,164,0,164,0.16,15
5,TAMANA,Yuva Bharat Rashtraseva Party,115,0,115,0.12,15
6,RAJESH GUPTA,Bharat Lok Sewak Party,99,1,100,0.1,15
7,JUGAL CHAWLA,Independent,76,0,76,0.08,15
8,NOTA,None of the Above,672,1,673,0.68,15
1,TILAK RAM GUPTA,Bharatiya Janata Party,58836,237,59073,53.36,16
2,PAWAN GARG,Bahujan Samaj Party,562,4,566,0.51,16
3,PREETI JITENDER TOMAR,Aam Aadmi Party,43083,94,43177,39,16
4,SATENDER SHARMA,Indian National Congress,6867,30,6897,6.23,16
5,SUBHASH,Asankhya Samaj Party,180,1,181,0.16,16
6,SURENDRA SINGH BASOYA,Peoples Party of India (Democratic),114,1,115,0.1,16
7,NOTA,None of the Above,682,6,688,0.62,16
1,POONAM SHARMA,Bharatiya Janata Party,54414,307,54721,51.24,17
2,RAGINI NAYAK,Indian National Congress,6311,37,6348,5.94,17
3,RAJESH GUPTA,Aam Aadmi Party,43194,102,43296,40.54,17
4,HIRA LAL,Bahujan Samaj Party,1046,1,1047,0.98,17
5,DEVENDER KUMAR,Communist Party of India,190,0,190,0.18,17
6,MAHESH BANSAL,Right to Recall Party,64,0,64,0.06,17
7,SHEELA DEVI,Garib Ekta Party,63,0,63,0.06,17
8,AAKASH GOEL,Independent,233,1,234,0.22,17
9,MUKESH JAIN,Independent,173,0,173,0.16,17
10,NOTA,None of the Above,652,0,652,0.61,17
1,AKHILESH PATI TRIPATHI,Aam Aadmi Party,38608,85,38693,40.17,18
2,ASHOK GOEL,Bharatiya Janata Party,51848,260,52108,54.1,18
3,KANWAR KARAN SINGH,Indian National Congress,3886,22,3908,4.06,18
4,CHUNNI LAL,Bahujan Samaj Party,372,0,372,0.39,18
5,AWDHESH KUMAR JHA,Right to Recall Party,33,0,33,0.03,18
6,PANKAJ KUMAR,Rashtravadi Janata Party,58,0,58,0.06,18
7,VIVEK GIRI,Aapki Apni Party (Peoples),118,0,118,0.12,18
8,CHANDER PAL,Independent,119,0,119,0.12,18
9,ROMAN RASHID,Independent,224,0,224,0.23,18
10,NOTA,None of the Above,682,3,685,0.71,18
1,ANIL BHARDWAJ,Indian National Congress,10022,35,10057,8.49,19
2,MANOJ KUMAR JINDAL,Bharatiya Janata Party,49671,199,49870,42.12,19
3,SHAIL KUMARI,Bahujan Samaj Party,708,1,709,0.6,19
4,SOM DUTT,Aam Aadmi Party,56070,107,56177,47.45,19
5,ANITA BANSAL,Asankhya Samaj Party,123,0,123,0.1,19
6,ASHA RANI,Socialist Unity Centre Of India (COMMUNIST),184,0,184,0.16,19
7,UMESH RATHOR,Atulya Bharat Party,49,1,50,0.04,19
8,MADHU BALA,Jai Maha Bharath Party,213,0,213,0.18,19
9,MEENAKSHI KUMARI,Bharatiya Liberal Party,247,0,247,0.21,19
10,LAXMI THAKUR SINGHAL,Abhinav Bharat Party,84,0,84,0.07,19
11,CA SOHARSH GULGULIA JAIN,Jantantrik Samta Party,100,0,100,0.08,19
12,NOTA,None of the Above,584,2,586,0.49,19
1,KALI CHARAN,Bahujan Samaj Party,246,0,246,0.35,20
2,PUNARDEEP SINGH SAWHNEY (SABBY),Aam Aadmi Party,38932,61,38993,54.79,20
3,MUDIT AGARWAL,Indian National Congress,9038,27,9065,12.74,20
4,SATISH JAIN,Bharatiya Janata Party,22359,62,22421,31.5,20
5,KHALID UR REHMAN,Nationalist Congress Party,81,0,81,0.11,20
6,MOHAMMAD MURSALEEN,Indian National Socialistic Action Forces,45,0,45,0.06,20
7,RAHUL TIWARI,Right to Recall Party,69,0,69,0.1,20
8,NOTA,None of the Above,249,4,253,0.36,20
1,AALEY MOHAMMED IQBAL,Aam Aadmi Party,58041,79,58120,68.8,21
2,ASIM AHMED KHAN,Indian National Congress,10274,21,10295,12.19,21
3,TEJ RAM,Bahujan Samaj Party,129,1,130,0.15,21
4,DEEPTI INDORA,Bharatiya Janata Party,15351,45,15396,18.23,21
5,MOHD JAVED,Nationalist Congress Party,56,0,56,0.07,21
6,AMAR NATH,Independent,93,0,93,0.11,21
7,ZAINUDDIN,Independent,10,1,11,0.01,21
8,FIRDOUS AHMAD,Independent,31,0,31,0.04,21
9,BHAGWAN DASS,Independent,35,0,35,0.04,21
10,MOHAMMAD AHMED SAIFI,Independent,60,0,60,0.07,21
11,MOAZAM KHAN,Independent,31,0,31,0.04,21
12,NOTA,None of the Above,217,0,217,0.26,21
1,IMRAN HUSSAIN,Aam Aadmi Party,56932,72,57004,58,22
2,KAMAL BAGRI,Bharatiya Janata Party,27119,62,27181,27.66,22
3,SONU,Bahujan Samaj Party,190,0,190,0.19,22
4,HAROON YUSUF,Indian National Congress,13038,21,13059,13.29,22
5,ABRAR,Aam Aadmi Parivartan Party,224,0,224,0.23,22
6,MD HAROON,Nationalist Congress Party,38,0,38,0.04,22
7,BABU LAL,Independent,130,1,131,0.13,22
8,MOHD. SHADAB,Independent,72,0,72,0.07,22
9,HANSA,Independent,77,0,77,0.08,22
10,NOTA,None of the Above,299,2,301,0.31,22
1,DUSHYANT GAUTAM,Bharatiya Janata Party,44750,117,44867,43.65,23
2,RAHUL KUMAR,Indian National Congress,4232,20,4252,4.14,23
3,RANJEET,Bahujan Samaj Party,624,2,626,0.61,23
4,VISHESH RAVI,Aam Aadmi Party,52153,144,52297,50.88,23
5,SHIV KUMAR,Rashtriya Aikta Manch Party,116,0,116,0.11,23
6,DEEPAK KUMAR,Independent,87,1,88,0.09,23
7,NOTA,None of the Above,543,5,548,0.53,23
1,KRISHNA TIRATH,Indian National Congress,4610,44,4654,3.97,24
2,PRAVESH RATN,Aam Aadmi Party,57408,104,57512,49,24
3,RAAJ KUMAR ANAND,Bharatiya Janata Party,53273,190,53463,45.55,24
4,RAM AVTAR,Bahujan Samaj Party,712,2,714,0.61,24
5,ASHOK KUMAR,Aazad Samaj Party (Kanshi Ram),255,0,255,0.22,24
6,NOTA,None of the Above,768,4,772,0.66,24
1,AVINASH GUPTA,Bahujan Samaj Party,848,3,851,0.78,25
2,RAJENDER SINGH,Indian National Congress,3316,18,3334,3.05,25
3,SHIVCHARAN GOEL,Aam Aadmi Party,45827,81,45908,41.98,25
4,HARISH KHURANA,Bharatiya Janata Party,57364,201,57565,52.64,25
5,GOURAV BOTHRA,Right to Recall Party,124,0,124,0.11,25
6,MAHESH DUBEY,Bharatiya Liberal Party,35,0,35,0.03,25
7,VIJAY KUMAR SHARMA,Rashtriya Manav Party,63,0,63,0.06,25
8,VISHAL SAHNI,Voters Party  International,70,0,70,0.06,25
9,SANAULLAH,Nationalist Congress Party,60,0,60,0.05,25
10,GAURI SHANKAR,Independent,170,0,170,0.16,25
11,SADRE ALAM,Independent,415,1,416,0.38,25
12,HARISH,Independent,76,0,76,0.07,25
13,NOTA,None of the Above,687,2,689,0.63,25
1,KAILASH GANGWAL,Bharatiya Janata Party,51824,195,52019,46.08,26
2,J. P. PANWAR,Indian National Congress,17878,80,17958,15.91,26
3,RAKHI BIRLA,Aam Aadmi Party,41034,86,41120,36.42,26
4,ROOP SINGH AHIRWAR,Bahujan Samaj Party,319,2,321,0.28,26
5,RANDHIR KUMAR,Asankhya Samaj Party,66,0,66,0.06,26
6,RANDHIR SINGH TANDI,Jai Maha Bharath Party,204,0,204,0.18,26
7,ROHIT KASHYAP,Hamara Sahi Vikalp Party,105,0,105,0.09,26
8,DHARAMVEER,Independent,206,0,206,0.18,26
9,RAVI,Independent,113,0,113,0.1,26
10,NOTA,None of the Above,773,5,778,0.69,26
1,A DHANWATI CHANDELA A,Aam Aadmi Party,45835,107,45942,40.02,27
2,DHARAM PAL CHANDELA,Indian National Congress,3171,27,3198,2.79,27
3,MANJINDER SINGH SIRSA,Bharatiya Janata Party,63883,249,64132,55.86,27
4,SHASHI PABHA,Bahujan Samaj Party,286,2,288,0.25,27
5,KAMLA DEVI,Aapki Apni Party (Peoples),64,1,65,0.06,27
6,KARAN TALWAR,Aam Aadmi Parivartan Party,225,0,225,0.2,27
7,JAYA RAMAN,Sanjhi Virasat Party,89,0,89,0.08,27
8,VISHAL SANGWAN,Right to Recall Party,84,0,84,0.07,27
9,NOTA,None of the Above,778,5,783,0.68,27
1,PREM BALLABH,Indian National Congress,4175,77,4252,4.13,28
2,BINDU KUMAR,Bahujan Samaj Party,566,3,569,0.55,28
3,SHYAM SHARMA,Bharatiya Janata Party,49608,571,50179,48.7,28
4,SURINDER KUMAR SETIA,Aam Aadmi Party,43262,285,43547,42.26,28
5,PREETAM CHAND,Rashtriya Janshakti Party (Secular),81,0,81,0.08,28
6,MOHAN LAL BHARDWAJ,Bharatheeya Jawan Kisan Party,83,0,83,0.08,28
7,ASHOK KUMAR,Independent,28,1,29,0.03,28
8,MAYANK MEHTA,Independent,98,0,98,0.1,28
9,RAJ KUMARI DHILLON,Independent,3367,31,3398,3.3,28
10,SABIR KHAN,Independent,89,2,91,0.09,28
11,NOTA,None of the Above,705,8,713,0.69,28
1,ASHOK KUMAR GAUTAM,Bahujan Samaj Party,296,5,301,0.31,29
2,JARNAIL SINGH,Aam Aadmi Party,51955,179,52134,54.02,29
3,PARVINDER SINGH ALIAS P S BAWA,Indian National Congress,2716,31,2747,2.85,29
4,SHVETA SAINI,Bharatiya Janata Party,40233,245,40478,41.94,29
5,RAJIV KUMAR BABBAR,Independent,91,0,91,0.09,29
6,SHWETA,Independent,145,0,145,0.15,29
7,NOTA,None of the Above,600,7,607,0.63,29
1,ASHISH SOOD,Bharatiya Janata Party,68564,422,68986,55.27,30
2,PARVEEN KUMAR,Aam Aadmi Party,50045,175,50220,40.23,30
3,RAVI PARTAP RAO,Bahujan Samaj Party,458,3,461,0.37,30
4,HARBANI KAUR,Indian National Congress,3305,40,3345,2.68,30
5,KASHMIR CHAND,Buland Bharat Party,47,1,48,0.04,30
6,CHAMAN LAL VERMA,Aam Janshakti Party,69,1,70,0.06,30
7,DHARAM VEER,Suheldev Bharatiya Samaj Party,61,0,61,0.05,30
8,MD NAVEEN,Nationalist Congress Party,80,0,80,0.06,30
9,NIZAMUDDIN KHAN,Adarshwaadi Congress Party,43,0,43,0.03,30
10,MOHD OJER,Azad Adhikar Sena,91,0,91,0.07,30
11,RAJ KUMAR,All India National Raksha Sena,20,0,20,0.02,30
12,ALTAF AHMAD,Independent,182,1,183,0.15,30
13,ASHISH SOOD,Independent,56,1,57,0.05,30
14,TARUN KUMAR SHARMA,Independent,60,0,60,0.05,30
15,PRAVEEN KUMAR,Independent,193,0,193,0.15,30
16,PRAVEEN KUMAR,Independent,210,0,210,0.17,30
17,NOTA,None of the Above,684,7,691,0.55,30
1,KRISHNA THAKUR,Bahujan Samaj Party,2632,10,2642,0.97,31
2,JITENDER SOLANKI,Indian National Congress,8397,68,8465,3.09,31
3,PANKAJ KUMAR SINGH,Bharatiya Janata Party,135038,526,135564,49.54,31
4,MAHINDER YADAV,Aam Aadmi Party,122419,269,122688,44.83,31
5,UMESH CHAUHAN,Aazad Samaj Party (Kanshi Ram),443,0,443,0.16,31
6,PREM PAL SINGH,Rashtriya Janshakti Party (Secular),97,0,97,0.04,31
7,RAJU RICHARIYA,Rashtriya Rashtrawadi Party,69,0,69,0.03,31
8,RANJEET KUMAR,Rashtriya Manav Party,139,0,139,0.05,31
9,LALA RAM,Bhartiya Panchsheel Party,297,0,297,0.11,31
10,SHARDA DIXIT,Socialist Unity Centre Of India (COMMUNIST),420,0,420,0.15,31
11,SHEJO VARGHESE,Communist Party of India,685,2,687,0.25,31
12,AMAN SAINI,Independent,286,0,286,0.1,31
13,HIRA LAL SAH,Independent,390,1,391,0.14,31
14,NOTA,None of the Above,1452,8,1460,0.53,31
1,PAWAN SHARMA,Bharatiya Janata Party,103137,476,103613,52.84,32
2,POSH BALYAN,Aam Aadmi Party,73705,168,73873,37.67,32
3,MANI RAM,Bahujan Samaj Party,983,8,991,0.51,32
4,MUKESH SHARMA,Indian National Congress,15474,91,15565,7.94,32
5,DUSHYANT THAKUR,Yuva Bharat Rashtraseva Party,185,0,185,0.09,32
6,RAJIV BHRIGUKUMAR,Rashtriya Lok Janshakti Party,79,0,79,0.04,32
7,SHYAM BABU,Gareeb Aadmi Party,168,0,168,0.09,32
8,DINESH KUMAR SAH,Independent,204,2,206,0.11,32
9,JOURNALIST RAMESH KUMAR JAIN @ NIRBHIK,Independent,196,0,196,0.1,32
10,NOTA,None of the Above,1209,8,1217,0.62,32
1,ADARSH SHASTRI,Indian National Congress,6723,50,6773,4.86,33
2,PARDEEP KUMAR,Bahujan Samaj Party,541,4,545,0.39,33
3,PARDUYMN SINGH RAJPUT,Bharatiya Janata Party,68832,305,69137,49.56,33
4,VINAY MISHRA,Aam Aadmi Party,61136,172,61308,43.95,33
5,ARAVENDRA KUMAR,Suheldev Bharatiya Samaj Party,131,0,131,0.09,33
6,G. THULASEEDHARAN,Peoples Green Party,58,0,58,0.04,33
7,MEHAR CHARAN,Samaj Vikas Kranti Party,76,0,76,0.05,33
8,YOGESH SWAMI,Right to Recall Party,44,0,44,0.03,33
9,RAJNEESH KUMAR JHA,National Youth Party,130,0,130,0.09,33
10,RAVI RATHORE,Republican Sena,73,1,74,0.05,33
11,RAMESHWAR MAHTO,Rashtriya Manav Party,223,0,223,0.16,33
12,ASHOK JINDAL,Independent,172,0,172,0.12,33
13,GAUTAM SINGH BIHARI,Independent,104,0,104,0.07,33
14,NOTA,None of the Above,725,4,729,0.52,33
1,KAMLESH KUMAR,Bahujan Samaj Party,1116,18,1134,0.41,34
2,RAGHVINDER SINGH,Indian National Congress,9565,120,9685,3.47,34
3,SUMESH SHOKEEN,Aam Aadmi Party,117042,530,117572,42.16,34
4,SANDEEP SEHRAWAT,Bharatiya Janata Party,144938,1357,146295,52.46,34
5,ARVIND KUMAR PANDEY,Rashtriya Janshakti Party (Secular),345,0,345,0.12,34
6,NIRAJ KUMAR,National Youth Party,73,0,73,0.03,34
7,PRABHAT KUMAR,One Bharat Citizen Party,157,5,162,0.06,34
8,MOHINDER SINGH,Rashtriya Rashtrawadi Party,88,0,88,0.03,34
9,YOGESH KUMAR SHARMA,Right to Recall Party,121,0,121,0.04,34
10,VINOD KUMAR CHAUHAN,Suheldev Bharatiya Samaj Party,156,1,157,0.06,34
11,PUNAM PANDEY,Independent,498,3,501,0.18,34
12,YOGESH KUMAR,Independent,569,0,569,0.2,34
13,RAJNI SHARMA,Independent,174,0,174,0.06,34
14,NOTA,None of the Above,1994,24,2018,0.72,34
1,TARUN KUMAR,Aam Aadmi Party,72024,675,72699,40.31,35
2,NEELAM PAHALWAN,Bharatiya Janata Party,100058,1650,101708,56.4,35
3,ROHIT,Bahujan Samaj Party,873,30,903,0.5,35
4,SUSHMA DEVI YADAV,Indian National Congress,2839,63,2902,1.61,35
5,JALANDHAR PANDIT,"Proutist Bloc, India",210,4,214,0.12,35
6,BHARAT SINGH,Peoples Party of India (Democratic),88,5,93,0.05,35
7,RAHUL KUMAR,Right to Recall Party,70,1,71,0.04,35
8,MANOJ KUMAR,Independent,173,0,173,0.1,35
9,MANGE RAM SANGWAN,Independent,222,3,225,0.12,35
10,NOTA,None of the Above,1317,29,1346,0.75,35
1,KAMAL SINGH,Bahujan Samaj Party,698,4,702,0.54,36
2,KAILASH GAHLOT,Bharatiya Janata Party,64587,364,64951,49.77,36
3,COL DEVINDER KUMAR SEHRAWAT,Indian National Congress,9334,75,9409,7.21,36
4,SURENDER BHARDWAJ,Aam Aadmi Party,53462,213,53675,41.13,36
5,NARENDER SINGH,Republican Sena,96,0,96,0.07,36
6,NAVEEN KUMAR,Hamara Sahi Vikalp Party,91,0,91,0.07,36
7,PUNAM PANDEY,Rashtravadi Loktantrik Party (India),153,0,153,0.12,36
8,LALITA TRIVEDI,Bhartiya Krishak Dal,48,0,48,0.04,36
9,AMRINA,Independent,113,0,113,0.09,36
10,NISHANT SEHRAWAT,Independent,192,1,193,0.15,36
11,MONIS KURESHI,Independent,225,0,225,0.17,36
12,SOM DUTT SHARMA,Independent,91,1,92,0.07,36
13,NOTA,None of the Above,755,1,756,0.58,36
1,KULDEEP SOLANKI,Bharatiya Janata Party,81589,457,82046,50.45,37
2,GEETA,Bahujan Samaj Party,805,5,810,0.5,37
3,JOGINDER SOLANKI,Aam Aadmi Party,72844,250,73094,44.95,37
4,MANGE RAM,Indian National Congress,4655,42,4697,2.89,37
5,DILIP KUMAR,Communist Party of India,325,1,326,0.2,37
6,MANU GAUTAM,Peoples Party of India (Democratic),220,1,221,0.14,37
7,PRASHANT CHAUHAN,Independent,301,1,302,0.19,37
8,NOTA,None of the Above,1109,10,1119,0.69,37
1,NAMIT KUMAR GAUTAM,Bahujan Samaj Party,232,0,232,0.49,38
2,PRADEEP KUMAR UPMANYU,Indian National Congress,4230,22,4252,8.96,38
3,BHUVAN TANWAR,Bharatiya Janata Party,20073,89,20162,42.48,38
4,VIRENDER SINGH KADIAN,Aam Aadmi Party,22140,51,22191,46.76,38
5,SACHIN,Bharatiya Sampuran Krantikari Party,70,0,70,0.15,38
6,SURENDER KUMAR,Peoples Party of India (Democratic),72,0,72,0.15,38
7,ASHOK AGYANI,Independent,149,0,149,0.31,38
8,NOTA,None of the Above,327,3,330,0.7,38
1,UMANG BAJAJ,Bharatiya Janata Party,46391,280,46671,48.01,39
2,DURGESH PATHAK,Aam Aadmi Party,45290,150,45440,46.74,39
3,VINEET YADAV,Indian National Congress,3995,20,4015,4.13,39
4,SHIV PRASAD VERMA,Bahujan Samaj Party,147,3,150,0.15,39
5,PANKAJ JAGYA,Republican Party of India (Athawale),65,0,65,0.07,39
6,PRAVEEN KUMAR BHARTI,Aazad Samaj Party (Kanshi Ram),155,0,155,0.16,39
7,UMANG,Independent,143,1,144,0.15,39
8,NOTA,None of the Above,565,6,571,0.59,39
1,ARVIND KEJRIWAL,Aam Aadmi Party,25865,134,25999,42.18,40
2,PARVESH SAHIB SINGH,Bharatiya Janata Party,29878,210,30088,48.82,40
3,VIRENDER,Bahujan Samaj Party,142,0,142,0.23,40
4,SANDEEP DIKSHIT,Indian National Congress,4531,37,4568,7.41,40
5,ARUN KUMAR SHARMA,Delhi Janta Party,21,0,21,0.03,40
6,ISHWAR CHAND,Bharatrashtra Democratic Party,4,0,4,0.01,40
7,JAGDEESH PRASAD,Samarth Bharatvarsh Party,22,0,22,0.04,40
8,DUGGIRALA NAGESWARA RAO,Jatiya Jana Sena Party,39,0,39,0.06,40
9,NARESH KUMAR,Aapki Apni Party (Peoples),37,0,37,0.06,40
10,NITYA NAND SINGH,Rashtriya Manav Party,8,0,8,0.01,40
11,MUKESH JAIN,Rashtrawadi Janlok Party (Satya),8,0,8,0.01,40
12,DR. MUNISH KUMAR RAIZADA,Bharatiya Liberal Party,75,1,76,0.12,40
13,RAVINDER SINGH RAWAT,Haryana Jansena Party,14,1,15,0.02,40
14,SANGHA NAND BAUDDH,Bhim Sena,8,0,8,0.01,40
15,SANTOSH KUMAR,Right to Recall Party,30,0,30,0.05,40
16,SANTOSH RAI,Abhinav Bharat Party,53,0,53,0.09,40
17,ANITA,Independent,55,0,55,0.09,40
18,ANURADHA RANA,Independent,72,0,72,0.12,40
19,DR. ABHILASHA,Independent,31,0,31,0.05,40
20,PANKAJ SHARMA,Independent,9,0,9,0.01,40
21,BHAWANA,Independent,11,0,11,0.02,40
22,SANJAY RAWAT,Independent,16,1,17,0.03,40
23,HAIDER ALI,Independent,9,0,9,0.01,40
24,NOTA,None of the Above,306,8,314,0.51,40
1,TARVINDER SINGH MARWAH,Bharatiya Janata Party,38675,184,38859,45.44,41
2,FARHAD SURI,Indian National Congress,7324,26,7350,8.6,41
3,MANISH SISODIA,Aam Aadmi Party,38081,103,38184,44.65,41
4,RAVINDRA SINGH RAVIYODAYA,Bahujan Samaj Party,154,1,155,0.18,41
5,ANIL KUMAR,Bhartiya Rashtrawadi Party,74,0,74,0.09,41
6,BIJENDER,Haryana Jansena Party,119,0,119,0.14,41
7,RAKESH SAGAR,Blue India Party,78,0,78,0.09,41
8,ASHOK BAMBANI,Independent,170,1,171,0.2,41
9,SUNIL KUMAR KUKREJA,Independent,80,0,80,0.09,41
10,NOTA,None of the Above,438,3,441,0.52,41
1,ABHISHEK DUTT,Indian National Congress,26918,101,27019,31.98,42
2,NEERAJ BASOYA,Bharatiya Janata Party,37896,171,38067,45.06,42
3,MAHESH KUMAR,Bahujan Samaj Party,149,1,150,0.18,42
4,RAMESH PAHELWAN,Aam Aadmi Party,18558,59,18617,22.04,42
5,PARTEEK GUPTA,Independent,157,1,158,0.19,42
6,NOTA,None of the Above,470,2,472,0.56,42
1,CHARANJEET KAUR,Bahujan Samaj Party,237,1,238,0.28,43
2,JITENDER KUMAR KOCHAR,Indian National Congress,6734,36,6770,7.96,43
3,SATISH UPADHYAY,Bharatiya Janata Party,39216,348,39564,46.53,43
4,SOMNATH BHARTI,Aam Aadmi Party,37280,153,37433,44.02,43
5,BHAVISH DHANKAR,Bhartiya Rashtriya Jansatta,144,0,144,0.17,43
6,DR. BHUPENDRA CHAURASIYA,Yuva Bharat Rashtraseva Party,162,0,162,0.19,43
7,MEGHNAD S.,Independent,192,0,192,0.23,43
8,NOTA,None of the Above,526,6,532,0.63,43
1,ANIL KUMAR SHARMA,Bharatiya Janata Party,42965,295,43260,56.55,44
2,PRAMILA TOKAS,Aam Aadmi Party,28652,155,28807,37.65,44
3,VISHESH KUMAR,Indian National Congress,3048,31,3079,4.02,44
4,SUNIL KAIN,Bahujan Samaj Party,202,0,202,0.26,44
5,ABHA JHA,Bhartiya Mahasangh Party,25,0,25,0.03,44
6,NEERAJ CHOURASIYA,Yuva Bharat Rashtraseva Party,99,0,99,0.13,44
7,LOKESH KUMAR MASTERJI,Rashtriya Rashtrawadi Party,76,0,76,0.1,44
8,VIJAY KUMAR,Peoples Party of India (Democratic),52,0,52,0.07,44
9,SARAVANAN,Rashtriya Manav Party,35,0,35,0.05,44
10,KULDEEP SINGH AHLAWAT,Independent,55,0,55,0.07,44
11,PERMILA,Independent,87,1,88,0.12,44
12,RAMESH ADVOCATE,Independent,100,0,100,0.13,44
13,RAI SINGH,Independent,76,0,76,0.1,44
14,NOTA,None of the Above,545,4,549,0.72,44
1,GAJENDER SINGH YADAV,Bharatiya Janata Party,48022,327,48349,41.67,45
2,PUSHPA SINGH,Indian National Congress,9250,88,9338,8.05,45
3,MAHENDER CHAUDHARY,Aam Aadmi Party,46426,141,46567,40.13,45
4,YOGESHWAR SINGH BISHT,Bahujan Samaj Party,771,7,778,0.67,45
5,MAHAVIR SINGH,Matrubhoomi Sewa Party,181,0,181,0.16,45
6,VIJAY LAL TAMTA,Peoples Party of India (Democratic),104,0,104,0.09,45
7,SHARDA SINGH,Right to Recall Party,140,0,140,0.12,45
8,BALYOGI BABA BALAKNATH,Independent,9685,46,9731,8.39,45
9,NOTA,None of the Above,840,6,846,0.73,45
1,KARTAR SINGH TANWAR,Bharatiya Janata Party,80128,341,80469,48.98,46
2,BRIJ LAL,Bahujan Samaj Party,739,11,750,0.46,46
3,BRAHM SINGH TANWAR,Aam Aadmi Party,74029,201,74230,45.18,46
4,RAJENDER SINGH TANWAR,Indian National Congress,6550,51,6601,4.02,46
5,ISLAM ALI,Aazad Samaj Party (Kanshi Ram),180,1,181,0.11,46
6,RICHA KUMARI,Republican Sena,77,0,77,0.05,46
7,DINESH TANWAR,Aapki Apni Party (Peoples),293,0,293,0.18,46
8,NARENDER,Nationalist Congress Party,173,0,173,0.11,46
9,DAYA RAM GURJAR,Independent,164,3,167,0.1,46
10,DHARMENDER,Independent,268,1,269,0.16,46
11,SANJAY NEGI,Independent,220,1,221,0.13,46
12,NOTA,None of the Above,862,6,868,0.53,46
1,ASMITA,Bahujan Samaj Party,2569,12,2581,1.64,47
2,PREM CHAUHAN,Aam Aadmi Party,86774,115,86889,55.09,47
3,RAJESH CHAUHAN,Indian National Congress,12147,64,12211,7.74,47
4,DEEPAK TANWAR,Lok Janshakti Party(Ram Vilas),50124,85,50209,31.83,47
5,DEVIKA,Rashtriya Lok Janshakti Party,536,2,538,0.34,47
6,BACHAN RAM,Matrubhoomi Sewa Party,943,4,947,0.6,47
7,RAJA RAM,Bhartiya Rashtrawadi Party,2225,4,2229,1.41,47
8,NOTA,None of the Above,2116,14,2130,1.35,47
1,DR. AJAY DUTT,Aam Aadmi Party,46122,163,46285,47.62,48
2,KHUSHI RAM CHUNAR,Bharatiya Janata Party,41877,178,42055,43.27,48
3,JAI PRAKASH,Indian National Congress,7129,43,7172,7.38,48
4,SEWA DASS,Bahujan Samaj Party,390,7,397,0.41,48
5,ARUN,Haryana Jansena Party,302,0,302,0.31,48
6,GULSHAN BHARTI,Right to Recall Party,32,0,32,0.03,48
7,DARSAN SINGH,Aazad Samaj Party (Kanshi Ram),255,6,261,0.27,48
8,RAJIV KUMAR,Bhartiya Rashtrawadi Party,85,0,85,0.09,48
9,ASHOK KUMAR,Independent,101,1,102,0.1,48
10,NOTA,None of the Above,497,1,498,0.51,48
1,CHANDAN KUMAR CHOUDHARY,Bharatiya Janata Party,53980,69,54049,42.99,49
2,MOHD ZAKIULLAH,Bahujan Samaj Party,795,1,796,0.63,49
3,DINESH MOHANIYA,Aam Aadmi Party,53658,47,53705,42.72,49
4,HARSH CHOUDHARY,Indian National Congress,15840,23,15863,12.62,49
5,QAMAR ALI,Nationalist Congress Party,78,0,78,0.06,49
6,RAVINDER SINGH,Republican Sena,68,0,68,0.05,49
7,SIRAJUDDIN,Aazad Samaj Party (Kanshi Ram),83,0,83,0.07,49
8,SUDHIR NEGI,Matrubhoomi Sewa Party,143,0,143,0.11,49
9,JAGDISH KUMAR VERMA,Independent,195,0,195,0.16,49
10,MAHENDER KUMAR,Independent,136,0,136,0.11,49
11,SATPAL,Independent,61,0,61,0.05,49
12,NOTA,None of the Above,534,3,537,0.43,49
1,GARVIT SINGHVI,Indian National Congress,6677,34,6711,6.46,50
2,NIYATI CHOUDHARY,Bahujan Samaj Party,235,0,235,0.23,50
3,SHIKHA ROY,Bharatiya Janata Party,49370,224,49594,47.74,50
4,SAURABH BHARADWAJ,Aam Aadmi Party,46231,175,46406,44.67,50
5,RAMESH JAGANNATH SHAH,Delhi Janta Party,96,0,96,0.09,50
6,SATISH KUMAR GULLIYA,Bhartiya Rashtrawadi Party,171,0,171,0.16,50
7,NOTA,None of the Above,666,5,671,0.65,50
1,ALKA LAMBA,Indian National Congress,4367,25,4392,4.11,51
2,ATISHI,Aam Aadmi Party,52058,96,52154,48.8,51
3,PRITAM SINGH,Bahujan Samaj Party,421,0,421,0.39,51
4,RAMESH BIDHURI,Bharatiya Janata Party,48478,155,48633,45.5,51
5,TANYA SINGH,Bhartiya Rashtrawadi Party,193,0,193,0.18,51
6,DEEPAK KAPILA,Azad Adhikar Sena,173,1,174,0.16,51
7,RAJAN SINGH,Aam Janta Party (India),84,1,85,0.08,51
8,RAJESH KUMAR,Veer Janshakti Party,23,0,23,0.02,51
9,SANGH MITRA,Bhim Sena,28,0,28,0.03,51
10,IQBAL AHMED SIDDIQUI,Independent,31,0,31,0.03,51
11,PARVEEN CHOUDHRY,Independent,58,0,58,0.05,51
12,RAVI,Independent,39,0,39,0.04,51
13,SANJAY,Independent,89,0,89,0.08,51
14,NOTA,None of the Above,556,0,556,0.52,51
1,AMJAD HASAN,Bahujan Samaj Party,1604,2,1606,1.4,52
2,ROHTASH KUMAR,Bharatiya Janata Party,47362,82,47444,41.28,52
3,VIRENDER SINGH,Indian National Congress,2303,10,2313,2.01,52
4,SAHI RAM,Aam Aadmi Party,62073,82,62155,54.08,52
5,KHURSHEED ABBAS ZAIDI,Rashtriya Bahujan Congress Party,133,0,133,0.12,52
6,CHAMAN LAL,Peoples Party of India (Democratic),86,0,86,0.07,52
7,NARESH KUMAR,Right to Recall Party,199,0,199,0.17,52
8,PARVEEN CHAUHAN,Samata Party,323,0,323,0.28,52
9,REKHA SINGH,Independent,143,0,143,0.12,52
10,NOTA,None of the Above,534,2,536,0.47,52
1,ARJUN SINGH BHADANA,Indian National Congress,3135,10,3145,1.51,53
2,JAGDISH CHAND,Communist Party of India  (Marxist),363,4,367,0.18,53
3,NARAYAN DUTT SHARMA,Bharatiya Janata Party,86865,238,87103,41.86,53
4,PARDEEP,Bahujan Samaj Party,1955,10,1965,0.94,53
5,RAM SINGH NETAJI,Aam Aadmi Party,112809,182,112991,54.3,53
6,IMRAN SAIFI,Nationalist Congress Party,322,0,322,0.15,53
7,BRIJPAL,Bharatiya Sampuran Krantikari Party,107,0,107,0.05,53
8,RAM BAHADUR,Akhil Bhartiya Manavatavadi Party,133,1,134,0.06,53
9,RAHUL RAI,Samata Party,466,0,466,0.22,53
10,HARI RAM,Rashtriya Bahujan Congress Party,185,0,185,0.09,53
11,OM PRAKASH GUPTA,Independent,176,0,176,0.08,53
12,DEEPAK RAWAT,Independent,219,0,219,0.11,53
13,NOTA,None of the Above,908,7,915,0.44,53
1,AMANATULLAH KHAN,Aam Aadmi Party,88751,192,88943,42.45,54
2,ARIBA KHAN,Indian National Congress,12638,101,12739,6.08,54
3,MANISH CHAUDHARY,Bharatiya Janata Party,65157,147,65304,31.17,54
4,SATISH KUMAR,Bahujan Samaj Party,755,1,756,0.36,54
5,MD INJAMAMUL HASSAN,Communist Party of India,259,0,259,0.12,54
6,MOHD ISLAM,Right to Recall Party,83,0,83,0.04,54
7,KANEEZ FATIMA,Aihra National Party,126,0,126,0.06,54
8,JAMALUDDIN,Buland Bharat Party,41,0,41,0.02,54
9,FIRDOS ALAM,Bhartiya Insan Party,148,0,148,0.07,54
10,RIZWANA KHATOON,Socialist Unity Centre Of India (COMMUNIST),221,0,221,0.11,54
11,SHIFA UR REHMAN KHAN,All India Majlis-E-Ittehadul Muslimeen,39498,60,39558,18.88,54
12,SHER MOHAMMAD,Azad Samaj Party,287,3,290,0.14,54
13,SHEIKH ARSALAN ULLAH CHISHTI,Independent,270,0,270,0.13,54
14,HAMMAD KHAN,Independent,180,0,180,0.09,54
15,NOTA,None of the Above,600,4,604,0.29,54
1,AMARDEEP,Indian National Congress,6115,32,6147,4.87,55
2,ANJANA PARCHA,Aam Aadmi Party,57692,133,57825,45.79,55
3,NAND LAL,Bahujan Samaj Party,1309,13,1322,1.05,55
4,RAVI KANT,Bharatiya Janata Party,58029,188,58217,46.1,55
5,VICKY,Aazad Samaj Party (Kanshi Ram),1677,4,1681,1.33,55
6,SARITA SINGH,Akhil Bharatiya Socialist Party,133,3,136,0.11,55
7,NAVEEN RAM,Independent,272,0,272,0.22,55
8,NOTA,None of the Above,679,4,683,0.54,55
1,AKSHAY KUMAR,Indian National Congress,7173,57,7230,5.62,56
2,KULDEEP KUMAR (MONU),Aam Aadmi Party,61609,183,61792,48,56
3,PRIYANKA GAUTAM,Bharatiya Janata Party,55243,256,55499,43.11,56
4,MUKESH KUMAR,Bahujan Samaj Party,2388,50,2438,1.89,56
5,AMARJEET PRASAD,Communist Party of India  (Marxist-Leninist)  (Liberation),94,6,100,0.08,56
6,ASHA KAMBLE,Republican Party of India (Athawale),188,0,188,0.15,56
7,NIKHIL KUMAR PIPAL,Right to Recall Party,121,1,122,0.09,56
8,SUNNY KUMAR,Aazad Samaj Party (Kanshi Ram),411,7,418,0.32,56
9,SURENDER SINGH,Swaraj Bhartiya Nyay Party,166,1,167,0.13,56
10,NOTA,None of the Above,771,5,776,0.6,56
1,ANIL KUMAR,Indian National Congress,16454,95,16549,11.94,57
2,AVADH OJHA,Aam Aadmi Party,45856,132,45988,33.17,57
3,OM SHANKAR PANDEY,Bahujan Samaj Party,747,9,756,0.55,57
4,Ravinder Singh Negi (Ravi Negi),Bharatiya Janata Party,73696,364,74060,53.41,57
5,GOPAL PRASAD,Delhi Janta Party,137,0,137,0.1,57
6,DEEPA DEVI,Aihra National Party,55,2,57,0.04,57
7,PRAKASH CHANDRA JOSHI,Bhartiya Rashtriya Jansatta,187,1,188,0.14,57
8,JAGDISH  OJHA,Independent,108,0,108,0.08,57
9,DIBLU SINGH,Independent,114,3,117,0.08,57
10,NOTA,None of the Above,688,4,692,0.5,57
1,ABHAY VERMA,Bharatiya Janata Party,65560,298,65858,52.11,58
2,B B TYAGI,Aam Aadmi Party,54148,168,54316,42.98,58
3,MOHD WAQAR CHOUDHARY,Bahujan Samaj Party,382,6,388,0.31,58
4,SUMIT SHARMA,Indian National Congress,4277,39,4316,3.42,58
5,ANIMA OJHA,Right to Recall Party,45,0,45,0.04,58
6,ISMAIL,Voice of Awam Party,32,0,32,0.03,58
7,KUSUM LATA,Peoples Party of India (Democratic),44,2,46,0.04,58
8,GANDHI GAUTAM,Aazad Samaj Party (Kanshi Ram),172,1,173,0.14,58
9,DANVEER VIDYALANKAR,Rashtra Nirman Party,41,0,41,0.03,58
10,DEEPAK PANDEY,Magadh Congress of Inda,107,0,107,0.08,58
11,NAMAHA,Nationalist Congress Party,48,0,48,0.04,58
12,VIKAS,Aapsi Sahyog Party,133,2,135,0.11,58
13,ANURAG KUMAR,Independent,48,0,48,0.04,58
14,JAGDISH KUMAR GARG,Independent,74,0,74,0.06,58
15,VIMAL KUMAR SAXENA,Independent,69,0,69,0.05,58
16,NOTA,None of the Above,680,6,686,0.54,58
1,OM PRAKASH SHARMA,Bharatiya Janata Party,71672,469,72141,57.7,59
2,DEEPAK SINGHAL,Aam Aadmi Party,46955,144,47099,37.67,59
3,RAJIV CHAUDHARY,Indian National Congress,3576,51,3627,2.9,59
4,RAJESH KUMAR YADAV,Bahujan Samaj Party,436,7,443,0.35,59
5,ANIL KUMAR,National Youth Party,47,0,47,0.04,59
6,GURMEET SINGH,Jai Maha Bharath Party,161,0,161,0.13,59
7,DEEPAK KUMAR,Bharatiy Aam Janta Adhikar Party,47,2,49,0.04,59
8,NEELAM SINGH,Peoples Party of India (Democratic),49,0,49,0.04,59
9,PARAG JAIN,Aam Aadmi Parivartan Party,142,0,142,0.11,59
10,BHAWANA BOTHRA,Veer Janshakti Party,217,0,217,0.17,59
11,NOTA,None of the Above,1042,5,1047,0.84,59
1,DR ANIL GOYAL,Bharatiya Janata Party,75623,299,75922,52.94,60
2,AMAR SINGH,Bahujan Samaj Party,544,8,552,0.38,60
3,GURCHARAN SINGH (RAJU),Indian National Congress,9356,37,9393,6.55,60
4,VIKAS BAGGA CA,Aam Aadmi Party,56332,92,56424,39.35,60
5,POONAM MAINI,National Youth Party,131,0,131,0.09,60
6,VIDHAYAK VIRENDRA PRADHAN GURJAR,Samrat Mihir Bhoj Samaj Party,96,0,96,0.07,60
7,VINOD KAPOOR,Independent,191,0,191,0.13,60
8,NOTA,None of the Above,687,9,696,0.49,60
1,ARVINDER SINGH LOVELY,Bharatiya Janata Party,56665,193,56858,53.94,61
2,KAMAL ARORA (DABBU),Indian National Congress,3433,20,3453,3.28,61
3,TIKRAJ SINGH,Bahujan Samaj Party,235,0,235,0.22,61
4,NAVEEN CHAUDHARY (DEEPU),Aam Aadmi Party,44059,51,44110,41.85,61
5,PAWAN CHOUDHRY,Jatiya Jana Sena Party,190,0,190,0.18,61
6,GULFAM,Independent,156,0,156,0.15,61
7,NOTA,None of the Above,402,0,402,0.38,61
1,JAGAT SINGH,Indian National Congress,3834,28,3862,3.05,62
2,JITENDER SINGH SHUNTY,Aam Aadmi Party,57449,161,57610,45.54,62
3,DHARMINDRA KUMAR KAIM,Bahujan Samaj Party,586,10,596,0.47,62
4,SANJAY GOYAL,Bharatiya Janata Party,62477,311,62788,49.63,62
5,KAMAL KISHORE,National Youth Party,145,0,145,0.11,62
6,NITIN GARG,Aam Aadmi Parivartan Party,181,1,182,0.14,62
7,RAJENDRA KUMAR PAL,Nationalist Congress Party,58,0,58,0.05,62
8,ASHOK SURANA,Independent,87,0,87,0.07,62
9,DILIP BANERJEE,Independent,52,0,52,0.04,62
10,VINAY CHAUDHARI,Independent,577,2,579,0.46,62
11,NOTA,None of the Above,555,3,558,0.44,62
1,MANOJ,Bahujan Samaj Party,855,12,867,0.63,63
2,RAJESH LILOTHIA,Indian National Congress,11788,35,11823,8.63,63
3,KU. RINKU,Bharatiya Janata Party,55766,219,55985,40.88,63
4,VEER SINGH DHINGAN,Aam Aadmi Party,66186,167,66353,48.45,63
5,AJAY KUMAR,Peoples Party of India (Democratic),276,1,277,0.2,63
6,ANIL KUMAR,Aazad Samaj Party (Kanshi Ram),650,4,654,0.48,63
7,CHARAN SINGH MALIYAN,Right to Recall Party,58,0,58,0.04,63
8,RAJESH,Bharatiya Sarvodaya Kranti Party,50,1,51,0.04,63
9,RAJESH KUMAR LOHIYA,Nationalist Congress Party,110,0,110,0.08,63
10,SAROJ BALA,Swatantra Jantaraj Party,163,0,163,0.12,63
11,ASHISH KUMAR,Independent,158,0,158,0.12,63
12,NOTA,None of the Above,453,5,458,0.33,63
1,ASHOK KUMAR,Bahujan Samaj Party,930,23,953,0.66,64
2,JITENDER MAHAJAN,Bharatiya Janata Party,82299,597,82896,57.44,64
3,SARITA SINGH,Aam Aadmi Party,54803,191,54994,38.11,64
4,SURESHVATI,Indian National Congress,3604,35,3639,2.52,64
5,AKESHAN DUT,Bhartiya Rashtriya Dal,48,0,48,0.03,64
6,ABHISHEK,Nationalist Congress Party,91,0,91,0.06,64
7,AMIT KUMAR SHARMA,Sanjhi Virasat Party,42,1,43,0.03,64
8,NASEEM USMAN,Bharatiya Liberal Party,63,0,63,0.04,64
9,PANKAJ GUPTA,Sarvodaya Prabhat Party,54,0,54,0.04,64
10,SUBHASH CHAND GUPTA,Bhartiya Rashtrawadi Party,30,0,30,0.02,64
11,SURENDER SINGH VISHWAKARMA,Aazad Samaj Party (Kanshi Ram),172,2,174,0.12,64
12,SANJEEV KUMAR,Jan Samuh Party,34,1,35,0.02,64
13,NITIN MITTAL,Independent,45,0,45,0.03,64
14,VIKAS TYAGI,Independent,548,2,550,0.38,64
15,SURESH PAL JAINTH,Independent,72,0,72,0.05,64
16,NOTA,None of the Above,628,2,630,0.44,64
1,ANIL KUMAR SHARMA (GAUR),Bharatiya Janata Party,36353,179,36532,27.38,65
2,ABDUL REHMAN,Indian National Congress,16524,27,16551,12.4,65
3,CHAUDHARY ZUBAIR AHMAD,Aam Aadmi Party,78866,143,79009,59.21,65
4,DEEPAK KUMAR,Bahujan Samaj Party,415,7,422,0.32,65
5,MOHD NAZIR,Republican Party of India (Athawale),107,0,107,0.08,65
6,SHABANA,Rashtriya Republican Party,177,0,177,0.13,65
7,SUMAN SHARMA,Sanjhi Virasat Party,50,0,50,0.04,65
8,S. M. AQIF,Independent,24,0,24,0.02,65
9,ISLAUDDIN,Independent,22,0,22,0.02,65
10,MOHD ZUBAIR MALIK,Independent,29,0,29,0.02,65
11,RAHISUDDIN AHMAD,Independent,44,0,44,0.03,65
12,MOHD SHAFI,Independent,72,0,72,0.05,65
13,SYED MUNEEB,Independent,46,0,46,0.03,65
14,NOTA,None of the Above,353,2,355,0.27,65
1,AJAY MAHAWAR,Bharatiya Janata Party,79706,281,79987,56.96,66
2,GAURAV SHARMA,Aam Aadmi Party,53828,101,53929,38.41,66
3,BHISHAM SHARMA,Indian National Congress,4859,24,4883,3.48,66
4,SUNDER LOHIYA,Bahujan Samaj Party,448,6,454,0.32,66
5,ANIL SINGH,Sanjhi Virasat Party,56,0,56,0.04,66
6,BABITA,Yuva Bharat Rashtraseva Party,114,0,114,0.08,66
7,ADVOCATE MEHAK DOGRA,Nationalist Congress Party,44,2,46,0.03,66
8,SHUBHAM,Right to Recall Party,84,0,84,0.06,66
9,GAURAV SHARMA,Independent,277,2,279,0.2,66
10,NOTA,None of the Above,587,1,588,0.42,66
1,ANIL KUMAR VASHISHT,Bharatiya Janata Party,56758,440,57198,39.93,67
2,GOPAL RAI,Aam Aadmi Party,76031,161,76192,53.19,67
3,MOHD ISHRAQ KHAN,Indian National Congress,8777,20,8797,6.14,67
4,BHUPENDER YADAV,Janhit Dal,93,0,93,0.06,67
5,MD NAZIR,Aman Samaj Party,201,0,201,0.14,67
6,MANOJ KUMAR,Akhil Bharatiya Socialist Party,75,1,76,0.05,67
7,SHIV KUMAR(KAKE),Sarvodaya Prabhat Party,89,0,89,0.06,67
8,MOHAMMAD ABDULLAH ANSARI,Independent,124,0,124,0.09,67
9,NOTA,None of the Above,471,3,474,0.33,67
1,ISHWAR SINGH,Indian National Congress,5840,65,5905,3.56,68
2,PRAVEEN NIMESH,Bharatiya Janata Party,71764,533,72297,43.54,68
3,LAL SINGH,Bahujan Samaj Party,2518,44,2562,1.54,68
4,SURENDRA KUMAR,Aam Aadmi Party,80086,418,80504,48.48,68
5,ATUL KUMAR,Swaraj Bhartiya Nyay Party,335,4,339,0.2,68
6,ARVIND KUMAR,Aazad Samaj Party (Kanshi Ram),3049,37,3086,1.86,68
7,CHARAN SINGH MALIYAN,Right to Recall Party,91,0,91,0.05,68
8,JAGDISH,Nationalist Congress Party,64,0,64,0.04,68
9,DHARAMVIR SINGH,Peoples Party of India (Democratic),193,2,195,0.12,68
10,BIR SAIN,Bharatiya Sarvodaya Kranti Party,145,0,145,0.09,68
11,MANJEET SINGH,Jan Samuh Party,125,4,129,0.08,68
12,SURESHPAL JAINTH,Independent,130,3,133,0.08,68
13,NOTA,None of the Above,589,12,601,0.36,68
1,ALI MEHDI,Indian National Congress,11732,31,11763,5.85,69
2,ASHOK KUMAR,Bahujan Samaj Party,1201,22,1223,0.61,69
3,ADEEL AHMAD KHAN,Aam Aadmi Party,67511,126,67637,33.62,69
4,MOHAN SINGH BISHT,Bharatiya Janata Party,84888,327,85215,42.36,69
5,ASHA CHAUDHARY,Bharatiya Sampuran Krantikari Party,236,0,236,0.12,69
6,MOHD USMAN BAKHSH,Rashtriya Janmorcha,151,0,151,0.08,69
7,MOHD. TAHIR HUSSAIN,All India Majlis-E-Ittehadul Muslimeen,33467,7,33474,16.64,69
8,DHARAM PAL,Bharatiya Sarvodaya Kranti Party,391,0,391,0.19,69
9,NASIRUDDIN GAURI,Rashtriya Republican Party,75,0,75,0.04,69
10,VISHAL,Peoples Party of India (Democratic),191,1,192,0.1,69
11,SAGAR TANHA,Peace Party,227,0,227,0.11,69
12,JITENDER KUMAR,Independent,122,0,122,0.06,69
13,NOTA,None of the Above,451,4,455,0.23,69
1,ASHOK AGARWAL,Communist Party of India  (Marxist),456,1,457,0.23,70
2,KAPIL MISHRA,Bharatiya Janata Party,106963,404,107367,53.39,70
3,DEVENDRA BHAIYA,Bahujan Samaj Party,1876,11,1887,0.94,70
4,MANOJ KUMAR TYAGI,Aam Aadmi Party,83843,169,84012,41.78,70
5,DR. P.K. MISHRA,Indian National Congress,3908,13,3921,1.95,70
6,NEERAJ,New India United Party,100,0,100,0.05,70
7,PRAKASH CHAND,Bahujan Dravida Party,278,0,278,0.14,70
8,YOGENDER,Bharatiya Sampuran Krantikari Party,89,1,90,0.04,70
9,SEEMA,Peoples Party of India (Democratic),128,0,128,0.06,70
10,SANJAY MISHRA (SITARAM),Nationalist Congress Party,165,0,165,0.08,70
11,SANDHIYA TIWARI,Akhil Bharatiya Socialist Party,70,1,71,0.04,70
12,H.M. HASHIM MALIK,Social Democratic Party Of India,491,0,491,0.24,70
13,AJAY SINGH NEGI,Independent,1002,4,1006,0.5,70
14,YOGESH SWAMY,Independent,228,1,229,0.11,70
15,VISHAL SHARMA,Independent,173,0,173,0.09,70
16,NOTA,None of the Above,706,3,709,0.35,70
