S.N.,Candidate,Party,EVM Votes,Postal Votes,Total Votes,% of Votes,Constituency
1,OM PARKASH GUJJAR,Aam Aadmi Party,854,4,858,0.59,1
2,CHARAN SINGH,Bahujan Samaj Party,1368,6,1374,0.94,1
3,PARDEEP CHAUDHARY,Indian National Congress,49544,185,49729,34.07,1
4,SHAKTI RANI SHARMA,Bharatiya Janata Party,60497,115,60612,41.53,1
5,AMIT SHARMA,Independent,582,0,582,0.4,1
6,GOPAL SUKHOMAJRI,Independent,31665,23,31688,21.71,1
7,VISHAL,Independent,377,0,377,0.26,1
8,NOTA,None of the Above,734,6,740,0.51,1
1,DR KSHITIJ CHOUDHARY,Indian National Lok Dal,1374,1,1375,0.98,2
2,CHANDER MOHAN,Indian National Congress,67253,144,67397,47.97,2
3,GIAN CHAND GUPTA,Bharatiya Janata Party,65277,123,65400,46.55,2
4,PREM GARG,Aam Aadmi Party,3329,3,3332,2.37,2
5,SUSHIL GARG,Jannayak Janta Party,1153,0,1153,0.82,2
6,KISHAN SINGH NEGI,Right to Recall Party,110,0,110,0.08,2
7,BHARAT BHUSHAN GURJAR,Bhartiya Veer Dal,58,0,58,0.04,2
8,NATASHA SOOD,Independent,233,2,235,0.17,2
9,M P SHARMA,Independent,305,0,305,0.22,2
10,SAROJ BALA,Independent,150,0,150,0.11,2
11,NOTA,None of the Above,984,3,987,0.7,2
1,GURPAL SINGH,Aam Aadmi Party,3244,17,3261,2.31,3
2,DR. PAWAN SAINI,Bharatiya Janata Party,46932,154,47086,33.33,3
3,SHALLEY CHAUDHARY,Indian National Congress,61865,315,62180,44.01,3
4,HARBILAS SINGH,Bahujan Samaj Party,27403,37,27440,19.42,3
5,SEEMA DEVI,Bhartiya Shakti Chetna Party,299,0,299,0.21,3
6,DHARAMPAL,Independent,297,0,297,0.21,3
7,NEETU,Independent,310,6,316,0.22,3
8,NOTA,None of the Above,408,2,410,0.29,3
1,ANIL VIJ,Bharatiya Janata Party,59686,172,59858,44.9,4
2,AVTAR SINGH,Jannayak Janta Party,808,1,809,0.61,4
3,ONKAR SINGH,Indian National Lok Dal,2857,6,2863,2.15,4
4,PARVINDER PAL PARI,Indian National Congress,14412,57,14469,10.85,4
5,RAJ KAUR GILL,Aam Aadmi Party,520,4,524,0.39,4
6,NAVEEN KUMAR,Yuga Thulasi Party,334,0,334,0.25,4
7,CHITRA SARWARA,Independent,52438,143,52581,39.44,4
8,JASWINDER GOLU,Independent,146,0,146,0.11,4
9,DHARMESH SOOD RINKU,Independent,764,0,764,0.57,4
10,NAVEEN BIDLA,Independent,234,0,234,0.18,4
11,SUNIL VERMA,Independent,100,0,100,0.08,4
12,NOTA,None of the Above,636,5,641,0.48,4
1,ASEEM GOEL NANEOLA,Bharatiya Janata Party,73204,140,73344,44.26,5
2,KETAN SHARMA,Aam Aadmi Party,1484,8,1492,0.9,5
3,NIRMAL SINGH MOHRA,Indian National Congress,84173,302,84475,50.98,5
4,MALKIT SINGH BHANOKHERI,Bahujan Samaj Party,1302,3,1305,0.79,5
5,PARUL NAGPAL UDAIPURIA,Aazad Samaj Party (Kanshi Ram),2420,3,2423,1.46,5
6,BHUPINDER,Independent,161,5,166,0.1,5
7,MAYUR NANDA,Independent,134,3,137,0.08,5
8,LALIT WALIA,Independent,97,0,97,0.06,5
9,SACHIN KUMAR,Independent,124,0,124,0.07,5
10,SATNAM SINGH,Independent,626,3,629,0.38,5
11,SUNIL DUTT,Independent,137,1,138,0.08,5
12,NOTA,None of the Above,1364,7,1371,0.83,5
1,GURTEJ SINGH,Aam Aadmi Party,1063,8,1071,0.67,6
2,POOJA,Indian National Congress,78705,384,79089,49.48,6
3,PRAKASH BHARTI,Indian National Lok Dal,8075,21,8096,5.07,6
4,DR RAVINDER DHEEN,Jannayak Janta Party,1556,10,1566,0.98,6
5,SANTOSH CHAUHAN SARWAN,Bharatiya Janata Party,66031,193,66224,41.43,6
6,PRITAM SINGH,Rashtrawadi Janlok Party (Satya),656,2,658,0.41,6
7,AJAIB SINGH SODHI,Independent,695,4,699,0.44,6
8,DALIP SINGH,Independent,1191,2,1193,0.75,6
9,HARKESH KUMAR,Independent,294,2,296,0.19,6
10,HAVELI RAM,Independent,465,0,465,0.29,6
11,NOTA,None of the Above,479,1,480,0.3,6
1,BALWANT SINGH,Bharatiya Janata Party,55608,227,55835,32.06,7
2,BRIJ PAL,Bahujan Samaj Party,53388,108,53496,30.72,7
3,RITA RANI,Aam Aadmi Party,933,5,938,0.54,7
4,RENU BALA,Indian National Congress,57248,286,57534,33.04,7
5,JAI PAL,Bhartiya Panchyat Party,329,6,335,0.19,7
6,JASBIR SINGH,Bhartiya Shakti Chetna Party,290,1,291,0.17,7
7,SOHIL,Aazad Samaj Party (Kanshi Ram),4459,8,4467,2.57,7
8,POOJA NAGRA,Independent,210,2,212,0.12,7
9,BETA MAMCHAND RATTU,Independent,437,0,437,0.25,7
10,NOTA,None of the Above,601,4,605,0.35,7
1,AKRAM KHAN,Indian National Congress,67094,309,67403,36.83,8
2,ADARSH PAL SINGH,Aam Aadmi Party,43702,111,43813,23.94,8
3,KANWAR PAL,Bharatiya Janata Party,60313,222,60535,33.07,8
4,DARSHAN LAL,Bahujan Samaj Party,6423,13,6436,3.52,8
5,ASHOK KUMAR,Aazad Samaj Party (Kanshi Ram),2683,1,2684,1.47,8
6,DR. NITESH CHOPRA (HONEY),Bhartiya Shakti Chetna Party,309,1,310,0.17,8
7,SONI,Indian Praja Congress,147,2,149,0.08,8
8,ADITYA KUMAR SHASTRI,Independent,166,0,166,0.09,8
9,GURDEV SINGH,Independent,113,1,114,0.06,8
10,YAJUVINDER SINGH,Independent,275,0,275,0.15,8
11,YOGESH SETHI (YOGI),Independent,398,0,398,0.22,8
12,NOTA,None of the Above,746,3,749,0.41,8
1,INTZAR ALI,Jannayak Janta Party,493,1,494,0.3,9
2,GHANSHYAM DASS,Bharatiya Janata Party,72967,218,73185,44.62,9
3,DILBAG SINGH,Indian National Lok Dal,35981,86,36067,21.99,9
4,RAMAN TYAGI,Indian National Congress,50455,293,50748,30.94,9
5,LALIT KUMAR TYAGI,Aam Aadmi Party,1649,6,1655,1.01,9
6,KANCHAN SHARMA,Bhartiya Shakti Chetna Party,141,1,142,0.09,9
7,NIRMALJEET KAUR,Indian Praja Congress,231,3,234,0.14,9
8,MANGA RAM,Peoples Party of India (Democratic),246,0,246,0.15,9
9,KAPIL,Independent,278,0,278,0.17,9
10,SUKHWINDER,Independent,229,0,229,0.14,9
11,NOTA,None of the Above,730,5,735,0.45,9
1,DHARAMPAL TIGRA,Bahujan Samaj Party,11153,29,11182,7.31,10
2,DR. BISHAN LAL SAINI,Indian National Congress,59868,348,60216,39.35,10
3,BHIM SINGH RATHI,Aam Aadmi Party,3233,12,3245,2.12,10
4,SHYAM SINGH RANA,Bharatiya Janata Party,73117,231,73348,47.93,10
5,DAYANAND,Ambedkar Samaj Vikas Party,259,2,261,0.17,10
6,DIWAN CHAND KAMBOJ,Bhartiya Shakti Chetna Party,601,5,606,0.4,10
7,MANDEEP TOPRA,Aazad Samaj Party (Kanshi Ram),2952,7,2959,1.93,10
8,ANIL KUMAR BATTA,Independent,176,1,177,0.12,10
9,ASHOK KUMAR,Independent,173,1,174,0.11,10
10,JAI PARKASH SHARMA,Independent,312,0,312,0.2,10
11,NOTA,None of the Above,535,3,538,0.35,10
1,JOGA SINGH UMRI,Aam Aadmi Party,627,5,632,0.43,11
2,NAYAB SINGH,Bharatiya Janata Party,69865,312,70177,47.4,11
3,MEWA SINGH,Indian National Congress,53745,378,54123,36.55,11
4,VINOD KUMAR SHARMA,Jannayak Janta Party,204,1,205,0.14,11
5,SAPNA BARSHAMI,Indian National Lok Dal,7418,21,7439,5.02,11
6,MAN SINGH BAPDA,Peoples Party of India (Democratic),133,0,133,0.09,11
7,VIKRAM SINGH SAINI,Bhartiya Shakti Chetna Party,143,1,144,0.1,11
8,SATISH KUMAR,Rashtriya Garib Dal,69,0,69,0.05,11
9,SUBHASH SAINI,Bhartiya Sarvodaya Party,48,0,48,0.03,11
10,ASHOK SAINI HAMID PUR,Independent,413,2,415,0.28,11
11,PARVEEN KUMAR,Independent,43,0,43,0.03,11
12,BHAJAN SINGH,Independent,262,3,265,0.18,11
13,RAJKUMAR,Independent,100,0,100,0.07,11
14,KASHYAP RAM CHANDER,Independent,611,0,611,0.41,11
15,VIKRAMJEET SINGH CHEEMA,Independent,11175,16,11191,7.56,11
16,SANDEEP GARG LADWA,Independent,2258,4,2262,1.53,11
17,NOTA,None of the Above,208,3,211,0.14,11
1,ASHA RANI,Aam Aadmi Party,925,7,932,0.77,12
2,CHANDER BHAN CHAUHAN,Bahujan Samaj Party,1635,3,1638,1.35,12
3,RAJEETA SINGH,Jannayak Janta Party,424,7,431,0.36,12
4,RAM KARAN,Indian National Congress,60819,231,61050,50.37,12
5,SUBHASH CHAND,Bharatiya Janata Party,54438,171,54609,45.05,12
6,KANTA AALLDIA,Mission Ekta Party,1333,0,1333,1.1,12
7,PAWAN KUMAR,Independent,358,0,358,0.3,12
8,RAJESH KANIPLA,Independent,235,0,235,0.19,12
9,SHIV NATH,Independent,185,0,185,0.15,12
10,NOTA,None of the Above,437,1,438,0.36,12
1,ASHOK KUMAR ARORA,Indian National Congress,69293,783,70076,48.93,13
2,KRISHAN BAJAJ,Aam Aadmi Party,2927,21,2948,2.06,13
3,TANUJA,Bahujan Samaj Party,1690,19,1709,1.19,13
4,SUBHASH SUDHA,Bharatiya Janata Party,66450,383,66833,46.67,13
5,SURYA PARTAP SINGH RATHORE,Jannayak Janta Party,381,4,385,0.27,13
6,JAIVEER SINGH RANGA,Republican Party of India (A),141,0,141,0.1,13
7,ABHISHEK PUNIA,Independent,159,0,159,0.11,13
8,ASHOK KUMAR,Independent,71,0,71,0.05,13
9,MEHAR,Independent,92,0,92,0.06,13
10,NOTA,None of the Above,790,8,798,0.56,13
1,GEHAL SINGH SANDHU,Aam Aadmi Party,884,6,890,0.69,14
2,JAI BHAGWAN SHARMA (DD),Bharatiya Janata Party,57832,163,57995,45.1,14
3,BALDEV SINGH WARAICH,Indian National Lok Dal,1763,9,1772,1.38,14
4,MANDEEP CHATHA,Indian National Congress,64240,308,64548,50.19,14
5,DR. SUKHWINDER KAUR,Jannayak Janta Party,1246,7,1253,0.97,14
6,KULDEEP SINGH,Shiromani Akali Dal (Amritsar)(Simranjit Singh Mann),106,1,107,0.08,14
7,GURNAM SINGH,Sanyukt Sangharsh Party,1169,1,1170,0.91,14
8,RAJAT SHARMA ISMAILABAD,Independent,394,1,395,0.31,14
9,SHYAM LAL GUMTHALA GARHU,Independent,166,0,166,0.13,14
10,NOTA,None of the Above,305,1,306,0.24,14
1,KULWANT RAM BAZIGAR,Bharatiya Janata Party,41572,159,41731,31.17,15
2,KRISHAN KUMAR,Jannayak Janta Party,5753,15,5768,4.31,15
3,DEVENDER HANS,Indian National Congress,64270,341,64611,48.26,15
4,POONAM RANI,Indian National Lok Dal,2393,16,2409,1.8,15
5,RAKESH KUMAR,Aam Aadmi Party,4527,13,4540,3.39,15
6,BHUPINDER SINGH,Shiromani Akali Dal (Amritsar)(Simranjit Singh Mann),394,5,399,0.3,15
7,MANOJ KUMAR,Mission Ekta Party,227,1,228,0.17,15
8,AMARJEET SINGH,Independent,1047,4,1051,0.79,15
9,NARESH KUMAR,Independent,12402,35,12437,9.29,15
10,NOTA,None of the Above,702,0,702,0.52,15
1,ANURAG DHANDA,Aam Aadmi Party,5452,30,5482,3.42,16
2,KAMLESH DHANDA,Bharatiya Janata Party,34484,239,34723,21.65,16
3,PRITAM KOLEKHAN,Jannayak Janta Party,2135,19,2154,1.34,16
4,RAMPAL MAJRA,Indian National Lok Dal,18706,144,18850,11.75,16
5,VIKAS SAHARAN,Indian National Congress,47589,553,48142,30.01,16
6,ANITA DHULL BADSIKRI,Independent,25184,118,25302,15.77,16
7,ASHISH RASILA,Independent,3687,4,3691,2.3,16
8,JITENDER SINGH URF DHOLA,Independent,217,0,217,0.14,16
9,RAJENDER KUMAR,Independent,199,1,200,0.12,16
10,RAJESH KUMAR,Independent,308,1,309,0.19,16
11,VINOD NIRMAL,Independent,14426,82,14508,9.04,16
12,SATVINDER SINGH RANA,Independent,5812,47,5859,3.65,16
13,SANDEEP KOTRA ADVOCATE,Independent,311,1,312,0.19,16
14,SALINDER KUMAR,Independent,270,1,271,0.17,16
15,NOTA,None of the Above,389,4,393,0.24,16
1,ANIL TANWER,Bahujan Samaj Party,3402,26,3428,2.03,17
2,ADITYA SURJEWALA,Indian National Congress,82844,900,83744,49.64,17
3,LEELA RAM,Bharatiya Janata Party,75140,480,75620,44.82,17
4,SATBIR SINGH GOYAT,Aam Aadmi Party,1743,6,1749,1.04,17
5,SANDEEP GARHI,Jannayak Janta Party,1902,8,1910,1.13,17
6,ASHWINI SHARMA HRITTWAL,Independent,212,1,213,0.13,17
7,CHAND KALYAN,Independent,135,0,135,0.08,17
8,PATASHO DEVI,Independent,299,1,300,0.18,17
9,BALRAJ SINGH,Independent,198,1,199,0.12,17
10,DR. MAHESH CHAND GAUR,Independent,164,2,166,0.1,17
11,SATISH KUMAR,Independent,268,1,269,0.16,17
12,FOUJI SURESH KUMAR,Independent,466,1,467,0.28,17
13,NOTA,None of the Above,512,2,514,0.3,17
1,NARENDER SHARMA,Aam Aadmi Party,2549,22,2571,1.89,18
2,SATPAL JAMBA,Bharatiya Janata Party,42544,261,42805,31.48,18
3,SULTAN JADAULA,Indian National Congress,25963,378,26341,19.37,18
4,HISAM SINGH BHUKKAL,Bahujan Samaj Party,4867,24,4891,3.6,18
5,BABU RAM,Socialist Unity Centre Of India (COMMUNIST),232,0,232,0.17,18
6,ENGINEER SURESH KUMAR,Peoples Party of India (Democratic),98,2,100,0.07,18
7,AMIT KUMAR,Independent,152,1,153,0.11,18
8,GURINDER SINGH HABRI,Independent,8060,37,8097,5.95,18
9,DINESH KAUSHIK,Independent,3076,29,3105,2.28,18
10,DILBAG BHANA,Independent,130,1,131,0.1,18
11,NARESH KUMAR PHARAL,Independent,393,3,396,0.29,18
12,PARMOD CHUHARMAJRA,Independent,311,0,311,0.23,18
13,RANDHIR SINGH GOLLEN,Independent,88,2,90,0.07,18
14,ADVOCATE RAKESH SHARMA,Independent,347,2,349,0.26,18
15,SAJJAN SINGH DHULL,Independent,4910,27,4937,3.63,18
16,SATBIR BHANA,Independent,40380,228,40608,29.86,18
17,SUNITA BATTAN,Independent,118,7,125,0.09,18
18,HARIPAL PAHALWAN,Independent,496,7,503,0.37,18
19,NOTA,None of the Above,226,3,229,0.17,18
1,AMAR SINGH,Aam Aadmi Party,552,4,556,0.37,19
2,DHARAM PAL,Indian National Congress,58776,281,59057,39.68,19
3,BALWAN SINGH,Indian National Lok Dal,2140,5,2145,1.44,19
4,BHAGWAN DASS,Bharatiya Janata Party,77657,245,77902,52.34,19
5,KARAM SINGH,Aazad Samaj Party (Kanshi Ram),387,0,387,0.26,19
6,GAURAV BAKHSHI,Rashtrawadi Janlok Party (Satya),1375,3,1378,0.93,19
7,DEEPAK KUMAR,Rashtriya Garib Dal,64,0,64,0.04,19
8,DYAL SINGH,Independent,247,2,249,0.17,19
9,NAVEEN KUMAR,Independent,142,2,144,0.1,19
10,RAJ KUMAR,Independent,5461,9,5470,3.68,19
11,RAJIV KUMAR,Independent,84,3,87,0.06,19
12,VED PARKASH,Independent,415,3,418,0.28,19
13,SARITA,Independent,228,2,230,0.15,19
14,SUNDARI,Independent,166,2,168,0.11,19
15,SUBHASH CHAND,Independent,238,0,238,0.16,19
16,NOTA,None of the Above,343,2,345,0.23,19
1,KULDEEP SINGH MANDHAN,Jannayak Janta Party,1180,7,1187,0.76,20
2,RAKESH KAMBOJ,Indian National Congress,64875,441,65316,41.71,20
3,RAM KUMAR KASHYAP,Bharatiya Janata Party,80198,267,80465,51.39,20
4,SURENDER UDANA,Bahujan Samaj Party,7481,17,7498,4.79,20
5,HAWA SINGH,Aam Aadmi Party,1476,7,1483,0.95,20
6,SANJAY KUMAR,Bhartiya Shakti Chetna Party,200,0,200,0.13,20
7,NOTA,None of the Above,425,3,428,0.27,20
1,JAGMOHAN ANAND,Bharatiya Janata Party,89737,269,90006,59.66,21
2,JETENDER ROYAL,Jannayak Janta Party,269,0,269,0.18,21
3,SUNIL BINDAL,Aam Aadmi Party,1714,9,1723,1.14,21
4,SUMITA VIRK,Indian National Congress,56073,281,56354,37.35,21
5,SURJEET SINGH,Indian National Lok Dal,944,6,950,0.63,21
6,ADVOCATE PARDEEP SAINI,Rashtriya Garib Dal,63,0,63,0.04,21
7,HARDEEP SINGH,Shiromani Akali Dal (Amritsar)(Simranjit Singh Mann),55,0,55,0.04,21
8,KAMAL,Independent,242,0,242,0.16,21
9,DHARMENDER,Independent,55,0,55,0.04,21
10,NEERU BALA SAINI,Independent,98,0,98,0.06,21
11,YASH DEV GOYAL,Independent,53,0,53,0.04,21
12,VARINDER KUMAR CHAWLA,Independent,149,0,149,0.1,21
13,NOTA,None of the Above,851,3,854,0.57,21
1,KRISHAN SINGH ALIAS MANNU KASHYAP,Indian National Lok Dal,1607,4,1611,0.92,22
2,JAIPAL SHARMA,Aam Aadmi Party,943,4,947,0.54,22
3,RAJPAL,Jannayak Janta Party,568,4,572,0.33,22
4,VARINDER SINGH RATHORE,Indian National Congress,82423,282,82705,47.33,22
5,HARVINDER KALYAN,Bharatiya Janata Party,87016,220,87236,49.92,22
6,VICKY,Jan Sewak Kranti Party,671,0,671,0.38,22
7,PARDEEP KASHYAP UPLI,Independent,396,0,396,0.23,22
8,BHUPINDER SINGH,Independent,143,1,144,0.08,22
9,NOTA,None of the Above,454,2,456,0.26,22
1,AMANDEEP SINGH JUNDLA,Aam Aadmi Party,4281,9,4290,2.64,23
2,GOPAL SINGH,Bahujan Samaj Party,27355,41,27396,16.88,23
3,YOGINDER SINGH RANA,Bharatiya Janata Party,54547,214,54761,33.74,23
4,SHAMSHER SINGH GOGI,Indian National Congress,52180,275,52455,32.32,23
5,PREM CHAND,Buland Bharat Party,328,0,328,0.2,23
6,MARATHA VIRENDER VERMA,Nationalist Congress Party – Sharadchandra Pawar,4206,12,4218,2.6,23
7,HARJEET SINGH,Shiromani Akali Dal (Amritsar)(Simranjit Singh Mann),306,2,308,0.19,23
8,JAIPAL PUNIA,Independent,348,2,350,0.22,23
9,ZILE RAM SHARMA,Independent,16233,69,16302,10.04,23
10,PARDEEP,Independent,124,0,124,0.08,23
11,BALJIT SINGH,Independent,128,0,128,0.08,23
12,RAMPHAL,Independent,270,2,272,0.17,23
13,REKHA,Independent,608,1,609,0.38,23
14,ADVOCATE SONIYA BOHAT,Independent,444,1,445,0.27,23
15,NOTA,None of the Above,305,1,306,0.19,23
1,MAHIPAL DHANDA,Bharatiya Janata Party,100881,198,101079,50.25,24
2,RAGHUNATH TANWAR KASHYAP,Jannayak Janta Party,378,3,381,0.19,24
3,RANBIR SINGH,Bahujan Samaj Party,1607,8,1615,0.8,24
4,SACHIN KUNDU,Indian National Congress,50673,194,50867,25.29,24
5,SUKHVIR MALIK,Aam Aadmi Party,1676,6,1682,0.84,24
6,AMIT MAURYA,Liberal Socialist Party,386,0,386,0.19,24
7,MASTER KULDEEP REDHU,Independent,128,0,128,0.06,24
8,DIPTI,Independent,87,0,87,0.04,24
9,DEVENDER,Independent,198,0,198,0.1,24
10,RAMESH SINGLA,Independent,240,0,240,0.12,24
11,VIJAY JAIN,Independent,43244,79,43323,21.54,24
12,NOTA,None of the Above,1149,4,1153,0.57,24
1,PARMOD KUMAR VIJ,Bharatiya Janata Party,81606,144,81750,55.66,25
2,RITU ARORA,Aam Aadmi Party,702,3,705,0.48,25
3,VARINDER KUMAR SHAH,Indian National Congress,45929,149,46078,31.37,25
4,SAROJ BALA GUR,Bahujan Samaj Party,693,3,696,0.47,25
5,BHATERI DEVI,Rashtriya Mazdoor Ekta Party,84,0,84,0.06,25
6,CA JAGDISH DHAMIJA,Independent,397,1,398,0.27,25
7,DILBAG SINGH KRANTIKARI,Independent,438,0,438,0.3,25
8,RAMESH KUMAR CHAUDHARY,Independent,133,0,133,0.09,25
9,ROHITA REWRI,Independent,15528,18,15546,10.59,25
10,SAWAMI AGNIVESH,Independent,169,0,169,0.12,25
11,HIMANSHU SHARMA,Independent,164,0,164,0.11,25
12,NOTA,None of the Above,701,1,702,0.48,25
1,AMIT KUMAR,Aam Aadmi Party,818,7,825,0.64,26
2,KRISHAN LAL PANWAR,Bharatiya Janata Party,67177,361,67538,52.09,26
3,BALBIR SINGH BALMIKI,Indian National Congress,53277,366,53643,41.37,26
4,SUNIL KUMAR,Jannayak Janta Party,418,1,419,0.32,26
5,SURAJBHAN,Indian National Lok Dal,999,8,1007,0.78,26
6,RAKESH SAROHA,Independent,4268,15,4283,3.3,26
7,SATYAWAN SHERA,Independent,1642,10,1652,1.27,26
8,NOTA,None of the Above,285,2,287,0.22,26
1,GANGARAM SWAMI,Jannayak Janta Party,846,2,848,0.5,27
2,JAIKANWAR ALIAS BITTU PAHALWAN,Aam Aadmi Party,1048,12,1060,0.63,27
3,DHARAM SINGH CHHOKER,Indian National Congress,61610,368,61978,36.87,27
4,MANMOHAN BHADANA,Bharatiya Janata Party,80950,343,81293,48.35,27
5,RAJESH,Indian National Lok Dal,1097,6,1103,0.66,27
6,RAVINDER MACHHRAULI,Independent,21066,66,21132,12.57,27
7,SATISH KUMAR,Independent,286,0,286,0.17,27
8,NOTA,None of the Above,414,5,419,0.25,27
1,ANIL KUMAR TYAGI,Jannayak Janta Party,340,3,343,0.24,28
2,KULDIP SHARMA,Indian National Congress,41686,353,42039,29.81,28
3,DEVENDER KAUSHIK,Bharatiya Janata Party,17523,82,17605,12.48,28
4,NAR SINGH,Bahujan Samaj Party,681,5,686,0.49,28
5,SAROJ BALA,Aam Aadmi Party,168,6,174,0.12,28
6,ANKUR KAUSHIK,Independent,84,0,84,0.06,28
7,KAVITA SHARMA,Independent,1929,2,1931,1.37,28
8,TAKDEER,Independent,305,0,305,0.22,28
9,DEVENDER KADYAN,Independent,76949,299,77248,54.77,28
10,RAM KUMAR,Independent,246,0,246,0.17,28
11,RAM MEHAR SINGH,Independent,147,0,147,0.1,28
12,NOTA,None of the Above,229,1,230,0.16,28
1,KRISHNA GAHLAWAT,Bharatiya Janata Party,64478,136,64614,46.08,29
2,JAI BHAGWAN ANTIL,Indian National Congress,59667,274,59941,42.75,29
3,PARMOD DAHIYA,Indian National Lok Dal,701,6,707,0.5,29
4,BIJENDER,Jannayak Janta Party,306,0,306,0.22,29
5,RAJESH SAROHA,Aam Aadmi Party,280,1,281,0.2,29
6,DEVENDER SINGH,Socialist Unity Centre Of India (COMMUNIST),225,0,225,0.16,29
7,MUKESH TAPSI,Rashtriya Majdoor Vikas Party,60,0,60,0.04,29
8,SANT DHARAMVEER CHOTIVALA,Yuga Thulasi Party,102,0,102,0.07,29
9,PRATEEK RAJKUMAR SHARMA,Independent,12243,19,12262,8.74,29
10,BIJENDER KUMAR,Independent,65,1,66,0.05,29
11,RAJESH KUMAR,Independent,60,0,60,0.04,29
12,RAHUL KIRORIWAL,Independent,634,1,635,0.45,29
13,SANDEEP KUMAR,Independent,74,0,74,0.05,29
14,SITENDER,Independent,400,0,400,0.29,29
15,NOTA,None of the Above,482,4,486,0.35,29
1,JAIVEER SINGH,Indian National Congress,52056,393,52449,46.12,30
2,PAWAN KHARKHODA,Bharatiya Janata Party,57891,193,58084,51.08,30
3,PRITAM KHOKAR,Indian National Lok Dal,1579,14,1593,1.4,30
4,MANJEET FARMANA,Aam Aadmi Party,391,6,397,0.35,30
5,RAMESH KHATAK,Jannayak Janta Party,204,3,207,0.18,30
6,AMAR SINGH BALMIKI,Rashtra Nirman Party,81,0,81,0.07,30
7,DR. PARVEEN KHARKHODA,Yuga Thulasi Party,186,2,188,0.17,30
8,RADHEY SHYAM,Peoples Party of India (Democratic),78,0,78,0.07,30
9,M. GAJE SINGH ADVOCATE,Independent,153,1,154,0.14,30
10,SATNARAYAN,Independent,148,1,149,0.13,30
11,NOTA,None of the Above,333,3,336,0.3,30
1,DEVINDER GAUTAM,Aam Aadmi Party,1193,7,1200,0.83,31
2,NIKHIL MADAAN,Bharatiya Janata Party,84575,252,84827,58.59,31
3,SARDHARAM SINGH,Indian National Lok Dal,1022,4,1026,0.71,31
4,SURENDER PANWAR,Indian National Congress,54727,473,55200,38.13,31
5,ISHWAR SINGH RATHEE,Socialist Unity Centre Of India (COMMUNIST),246,0,246,0.17,31
6,PAWAN SANATANI,Rashtriya Jatigat Aarakshan Virodhi Party,70,0,70,0.05,31
7,RAJIV VERMA,Communist Party of India,761,2,763,0.53,31
8,RAJESH,Aazad Samaj Party (Kanshi Ram),226,1,227,0.16,31
9,SUSHIL KUMAR MANAV,Yuga Thulasi Party,104,0,104,0.07,31
10,DR. KAMLESH KUMAR SAINI,Independent,116,0,116,0.08,31
11,DHARAMBIR FOJI,Independent,60,0,60,0.04,31
12,RAMESH KHATRI LAMBERDAR,Independent,208,0,208,0.14,31
13,NOTA,None of the Above,726,3,729,0.5,31
1,ARVIND KUMAR SHARMA,Bharatiya Janata Party,56754,301,57055,43.62,32
2,KULDEEP MALIK,Jannayak Janta Party,607,1,608,0.46,32
3,JAGBIR SINGH MALIK,Indian National Congress,46048,578,46626,35.65,32
4,DINESH KUMAR,Bahujan Samaj Party,920,5,925,0.71,32
5,SHIV KUMAR RANGEELA,Aam Aadmi Party,946,8,954,0.73,32
6,ARVIND,Independent,184,0,184,0.14,32
7,ARUN NINANIYA,Independent,175,3,178,0.14,32
8,RAJBIR,Independent,93,0,93,0.07,32
9,RAJVIR SINGH DAHIYA,Independent,8804,20,8824,6.75,32
10,SUNNY,Independent,140,0,140,0.11,32
11,HARSH CHHIKARA,Independent,14687,74,14761,11.29,32
12,NOTA,None of the Above,435,3,438,0.33,32
1,INDURAJ SINGH NARWAL,Indian National Congress,53787,675,54462,41.9,33
2,DEEPAK MALIK,Jannayak Janta Party,597,8,605,0.47,33
3,DHARAM VIR,Bahujan Samaj Party,1728,14,1742,1.34,33
4,PARDEEP SINGH SANGWAN,Bharatiya Janata Party,22359,225,22584,17.38,33
5,SANDEEP MALIK,Aam Aadmi Party,1279,7,1286,0.99,33
6,KAPOOR SINGH NARWAL,Independent,48585,235,48820,37.56,33
7,DEVENDER KUMAR ALIAS NITU MOR,Independent,198,2,200,0.15,33
8,NOTA,None of the Above,270,2,272,0.21,33
1,AMARJEET DHANDA,Jannayak Janta Party,2466,11,2477,1.78,34
2,KAVITA RANI,Aam Aadmi Party,1266,14,1280,0.92,34
3,YOGESH KUMAR,Bharatiya Janata Party,58728,337,59065,42.53,34
4,VINESH,Indian National Congress,64491,589,65080,46.86,34
5,SURENDER LATHER,Indian National Lok Dal,10123,35,10158,7.31,34
6,JOGI SUNIL,Rashtriya Garib Dal,46,1,47,0.03,34
7,AMIT SHARMA,Independent,74,2,76,0.05,34
8,INDERJEET,Independent,45,1,46,0.03,34
9,COACH JASVIR SINGH AHLAWAT,Independent,89,1,90,0.06,34
10,PREM,Independent,117,0,117,0.08,34
11,BIJENDER KUMAR,Independent,163,1,164,0.12,34
12,RAMRATTAN,Independent,68,1,69,0.05,34
13,NOTA,None of the Above,201,1,202,0.15,34
1,NISHA DESWAL,Aam Aadmi Party,185,8,193,0.13,35
2,PINKI KUNDU,Bahujan Samaj Party,806,16,822,0.56,35
3,RAM KUMAR GAUTAM,Bharatiya Janata Party,58699,284,58983,40.22,35
4,SUBHASH GANGOLI,Indian National Congress,54517,429,54946,37.47,35
5,SUSHIL BAIRAGI,Jannayak Janta Party,810,4,814,0.56,35
6,RAKESH KUMAR,Right to Recall Party,92,2,94,0.06,35
7,ADVOCATE RINKU MUANA,Republican Party of India (A),296,3,299,0.2,35
8,AJIT KUMAR,Independent,191,1,192,0.13,35
9,GURMEET,Independent,298,0,298,0.2,35
10,JASBIR DESWAL,Independent,20066,48,20114,13.72,35
11,BACHAN SINGH ARYA,Independent,8746,61,8807,6.01,35
12,MONU LOHAN,Independent,65,0,65,0.04,35
13,VIJAY PAL,Independent,223,1,224,0.15,35
14,VIPUL,Independent,420,0,420,0.29,35
15,SUBHASH SAINI,Independent,73,1,74,0.05,35
16,SUYAG,Independent,107,0,107,0.07,35
17,SUSHIL KUMAR,Independent,31,0,31,0.02,35
18,NOTA,None of the Above,169,3,172,0.12,35
1,DR KRISHAN LAL MIDDHA,Bharatiya Janata Party,68570,350,68920,50.96,36
2,DHARAM PAL TANWAR,Jannayak Janta Party,1003,11,1014,0.75,36
3,NARENDER NATH SHARMA,Indian National Lok Dal,1115,12,1127,0.83,36
4,MAHAVIR GUPTA,Indian National Congress,52365,695,53060,39.24,36
5,WAZIR DHANDA,Aam Aadmi Party,2068,10,2078,1.54,36
6,ANKIT KUMAR,Independent,83,0,83,0.06,36
7,PRADEEP SINGH,Independent,7601,38,7639,5.65,36
8,RAM PARKASH TAYAL,Independent,80,0,80,0.06,36
9,RITU RAJ BAMNIYA,Independent,370,3,373,0.28,36
10,RITESH SANGWAN SANGU,Independent,99,1,100,0.07,36
11,VIKAS,Independent,61,1,62,0.05,36
12,VED PARKASH,Independent,95,3,98,0.07,36
13,SURESH CHAND,Independent,55,0,55,0.04,36
14,NOTA,None of the Above,542,5,547,0.4,36
1,DUSHYANT CHAUTALA,Jannayak Janta Party,7914,36,7950,4.79,37
2,DEVENDER CHATAR BHUJ ATTRI,Bharatiya Janata Party,48721,247,48968,29.5,37
3,PAWAN FAUJI,Aam Aadmi Party,2480,15,2495,1.5,37
4,BRIJENDRA SINGH,Indian National Congress,48300,636,48936,29.48,37
5,VINOD PAL SINGH DULGANCH,Indian National Lok Dal,2641,12,2653,1.6,37
6,MASTER AJIT ARYA,Republican Party of India (A),192,0,192,0.12,37
7,AMARJEET SINGH,Shiromani Akali Dal (Amritsar)(Simranjit Singh Mann),307,1,308,0.19,37
8,ISHWAR KHATKAR FOUJI,Independent,263,3,266,0.16,37
9,GURMAIL SINGH,Independent,73,0,73,0.04,37
10,JOGIENDER,Independent,153,0,153,0.09,37
11,DILBAG SANDIL,Independent,7349,24,7373,4.44,37
12,DEVENDER,Independent,241,0,241,0.15,37
13,DEVENDER SHEORAN,Independent,191,0,191,0.12,37
14,COMRADE PAL SINGH,Independent,230,0,230,0.14,37
15,BIJENDER,Independent,338,0,338,0.2,37
16,BIJENDER SINGH,Independent,229,1,230,0.14,37
17,COMRADE RAMESH KHATKAR,Independent,127,0,127,0.08,37
18,VIKAS,Independent,13406,52,13458,8.11,37
19,VIRENDER GHOGHARIAN,Independent,31325,131,31456,18.95,37
20,VIRENDER PAL,Independent,181,0,181,0.11,37
21,NOTA,None of the Above,183,4,187,0.11,37
1,ANIL RANGA,Aam Aadmi Party,2369,5,2374,1.49,38
2,KRISHAN KUMAR,Bharatiya Janata Party,59187,287,59474,37.22,38
3,VIDYA RANI DANODA,Indian National Lok Dal,46021,282,46303,28.97,38
4,SANTOSH DANODA,Jannayak Janta Party,1534,13,1547,0.97,38
5,SATBIR DABLAIN,Indian National Congress,47445,530,47975,30.02,38
6,MANIRAM,Communist Party of India,578,1,579,0.36,38
7,RAM LAL KALYAN,Aam Janshakti Party,166,0,166,0.1,38
8,KITABA,Independent,114,0,114,0.07,38
9,GURMAIL,Independent,464,2,466,0.29,38
10,COMRADE SATYAVIR SINGH,Independent,352,0,352,0.22,38
11,NOTA,None of the Above,456,4,460,0.29,38
1,KUNAL KARAN SINGH,Indian National Lok Dal,9730,43,9773,5.42,39
2,DEVENDER SINGH BABLI,Bharatiya Janata Party,77363,323,77686,43.05,39
3,PARAMVIR SINGH,Indian National Congress,87892,630,88522,49.05,39
4,SUKHVINDER SINGH S/O AVTAR SINGH,Aam Aadmi Party,1604,12,1616,0.9,39
5,HAWA SINGH KHOBRA,Jannayak Janta Party,588,3,591,0.33,39
6,KARAMBIR,Independent,262,2,264,0.15,39
7,DHARAMPAL SHERE GILL,Independent,70,0,70,0.04,39
8,NARENDER SIWACH TINU,Independent,151,0,151,0.08,39
9,NIKHIL KUMAR,Independent,66,1,67,0.04,39
10,RAMESHWAR LAL,Independent,323,1,324,0.18,39
11,RAY SINGH,Independent,311,0,311,0.17,39
12,SUKHVINDER SINGH S/O BALDEV SINGH,Independent,394,0,394,0.22,39
13,NOTA,None of the Above,691,7,698,0.39,39
1,KAMAL BISLA,Aam Aadmi Party,2778,25,2803,1.44,40
2,DURA RAM,Bharatiya Janata Party,83517,403,83920,42.98,40
3,BALWAN SINGH DOULATPURIA,Indian National Congress,85442,730,86172,44.13,40
4,SUNAINA CHAUTALA,Indian National Lok Dal,9626,55,9681,4.96,40
5,SUBHASH CHANDER GORCHHIA,Jannayak Janta Party,3235,14,3249,1.66,40
6,BANTI BARETH,Peoples Party of India (Democratic),193,0,193,0.1,40
7,VIKRAM JEET KARWASRA,Mission Ekta Party,322,0,322,0.16,40
8,JAIBIR,Independent,143,1,144,0.07,40
9,TAHIR HUSAIN,Independent,67,0,67,0.03,40
10,DARBARA SINGH,Independent,215,0,215,0.11,40
11,MANDEEP KUMAR,Independent,75,0,75,0.04,40
12,RAMAN,Independent,129,0,129,0.07,40
13,RAJENDER CHOUDHARY URF KAKA,Independent,5801,15,5816,2.98,40
14,VINOD KUMAR,Independent,584,1,585,0.3,40
15,VISHVAMITTR,Independent,301,0,301,0.15,40
16,SANJAY KUMAR,Independent,381,0,381,0.2,40
17,SIMARJEET SINGH,Independent,130,0,130,0.07,40
18,SUDHIR,Independent,375,0,375,0.19,40
19,NOTA,None of the Above,712,6,718,0.37,40
1,JARNAIL SINGH,Indian National Congress,85883,543,86426,52.54,41
2,MUKHTYAR SINGH BAZIGAR,Aam Aadmi Party,3269,11,3280,1.99,41
3,RAMESH,Jannayak Janta Party,993,7,1000,0.61,41
4,RAMSARUP RAMA,Indian National Lok Dal,5731,38,5769,3.51,41
5,SUNITA DUGGAL,Bharatiya Janata Party,64751,233,64984,39.5,41
6,SURJIT SINGH PARDHAN,Peoples Party of India (Democratic),540,0,540,0.33,41
7,TEJPAL,Independent,609,1,610,0.37,41
8,RAJ KUMAR,Independent,396,0,396,0.24,41
9,RAJBIR,Independent,219,1,220,0.13,41
10,SURENDER KUMAR PHOOLAN,Independent,228,1,229,0.14,41
11,NOTA,None of the Above,1047,3,1050,0.64,41
1,GURJANT SINGH,Jannayak Janta Party,1399,6,1405,1,42
2,GURTEJ SINGH,Indian National Lok Dal,24033,167,24200,17.21,42
3,JASDEV SINGH,Aam Aadmi Party,3612,17,3629,2.58,42
4,RAJINDER SINGH DESUJODHA,Bharatiya Janata Party,43623,146,43769,31.13,42
5,SHISHPAL KEHARWALA,Indian National Congress,66335,393,66728,47.47,42
6,NOTA,None of the Above,847,5,852,0.61,42
1,ADITYA DEVILAL,Indian National Lok Dal,55716,358,56074,34.42,43
2,AMIT SIHAG,Indian National Congress,54955,509,55464,34.04,43
3,KULDEEP SINGH GADRANA,Aam Aadmi Party,6567,39,6606,4.05,43
4,DIGVIJAY SINGH CHAUTALA,Jannayak Janta Party,35180,81,35261,21.64,43
5,BALDEV SINGH MANGIANA,Bharatiya Janata Party,7051,88,7139,4.38,43
6,KULVEER SHAANT INSAN,Peoples Party of India (Democratic),107,1,108,0.07,43
7,DANA RAM,Bhartiya Shakti Chetna Party,101,0,101,0.06,43
8,ANKIT KUMAR,Independent,93,0,93,0.06,43
9,KHEM CHAND,Independent,281,1,282,0.17,43
10,GURVINDER SINGH,Independent,270,0,270,0.17,43
11,GULJARI LAL,Independent,197,2,199,0.12,43
12,RAJESH KUMAR,Independent,478,2,480,0.29,43
13,NOTA,None of the Above,852,4,856,0.53,43
1,ARJUN CHAUTALA,Indian National Lok Dal,43719,195,43914,30.41,44
2,SHEESHPAL KAMBOJ,Bharatiya Janata Party,15622,85,15707,10.88,44
3,SARV MITTER,Indian National Congress,39491,232,39723,27.51,44
4,HARPINDER SINGH,Aam Aadmi Party,4680,17,4697,3.25,44
5,DALBIR SINGH,Peoples Party of India (Democratic),242,0,242,0.17,44
6,LUCKY BALMIKI,Jan Sewak Kranti Party,140,0,140,0.1,44
7,SANJAY MALIK,Haryana Lokhit Party,477,0,477,0.33,44
8,ARJUN DASS,Independent,92,0,92,0.06,44
9,GAGAN DEEP JALANDHRA,Independent,936,6,942,0.65,44
10,GOTTAM SAHARAN,Independent,247,1,248,0.17,44
11,JOGINDER RAM,Independent,435,1,436,0.3,44
12,RANJIT SINGH,Independent,36313,88,36401,25.21,44
13,VIKRAM KHARIAN,Independent,452,3,455,0.32,44
14,SATPAL VERMA,Independent,271,0,271,0.19,44
15,NOTA,None of the Above,656,1,657,0.45,44
1,GOKUL SETIA,Indian National Congress,78466,554,79020,50,45
2,PAWAN SHERPURA,Jannayak Janta Party,1751,11,1762,1.11,45
3,SHYAM SUNDER,Aam Aadmi Party,846,7,853,0.54,45
4,GOPAL KANDA,Haryana Lokhit Party,71566,220,71786,45.43,45
5,JAIVEER SINGH,Buland Bharat Party,284,0,284,0.18,45
6,MANI RAM,Liberal Socialist Party,246,0,246,0.16,45
7,YOGESH ODD,Jan Sewak Kranti Party,163,2,165,0.1,45
8,OM PARKASH,Independent,79,4,83,0.05,45
9,CA DARVESH SWAMI,Independent,1167,15,1182,0.75,45
10,BHARAT KUMAR GIRDHAR @ SUNNY SINGH,Independent,577,0,577,0.37,45
11,MADAN LAL,Independent,446,2,448,0.28,45
12,YOGESH KANODIA,Independent,208,0,208,0.13,45
13,RAJBEER,Independent,302,0,302,0.19,45
14,NOTA,None of the Above,1110,5,1115,0.71,45
1,ANJANI LADHA,Jannayak Janta Party,1588,5,1593,1.01,46
2,ABHAY SINGH CHAUTALA,Indian National Lok Dal,62594,271,62865,39.67,46
3,AMIR CHAND TALWARA,Bharatiya Janata Party,13192,128,13320,8.41,46
4,BHARAT SINGH BENIWAL,Indian National Congress,77455,410,77865,49.14,46
5,MANISH ARORA,Aam Aadmi Party,879,6,885,0.56,46
6,NANAK SINGH,Jan Sewak Kranti Party,306,1,307,0.19,46
7,MAYANK GIDRA,Haryana Lokhit Party,182,0,182,0.11,46
8,BALDEV KUMAR,Independent,192,0,192,0.12,46
9,VIKRAM INDORA,Independent,442,1,443,0.28,46
10,SURJEET SINGH,Independent,257,0,257,0.16,46
11,NOTA,None of the Above,537,8,545,0.34,46
1,KRISHAN GANGWA PARJAPATI,Jannayak Janta Party,1288,9,1297,0.96,47
2,CHANDER PARKASH S/O ARJUN LAL,Indian National Congress,64955,416,65371,48.17,47
3,BHAVYA BISHNOI,Bharatiya Janata Party,63685,418,64103,47.24,47
4,BHUPENDER BENIWAL,Aam Aadmi Party,1806,8,1814,1.34,47
5,RANDEEP CHOUDARYVAS,Indian National Lok Dal,1853,16,1869,1.38,47
6,BALJEET SINGH,Bhartiya Kisan Party,40,0,40,0.03,47
7,AMIT,Independent,29,0,29,0.02,47
8,CHANDER PARKASH S/O RAJA RAM,Independent,51,0,51,0.04,47
9,PARMOD BASWANA,Independent,57,0,57,0.04,47
10,RAJESH KUMAR,Independent,323,0,323,0.24,47
11,RAMPHAL,Independent,197,0,197,0.15,47
12,RENU CHAHAL BALSAMAND,Independent,154,2,156,0.11,47
13,NOTA,None of the Above,388,2,390,0.29,47
1,ANOOP DHANAK,Bharatiya Janata Party,50069,287,50356,34.8,48
2,NARENDER KHANNA,Aam Aadmi Party,2040,10,2050,1.42,48
3,NARESH SELWAL,Indian National Congress,77580,868,78448,54.21,48
4,BALRAJ SINGH,Indian National Lok Dal,11365,82,11447,7.91,48
5,ROHTASH,Jannayak Janta Party,1212,6,1218,0.84,48
6,ANIL BITHMARA,Haryana Jan Sevak Party,291,0,291,0.2,48
7,BIRBAL SINGH,Independent,276,2,278,0.19,48
8,NOTA,None of the Above,619,8,627,0.43,48
1,CAPT. ABHIMANYU,Bharatiya Janata Party,71836,387,72223,43.75,49
2,UMED SINGH LOHAN,Indian National Lok Dal,4585,43,4628,2.8,49
3,JASSI PETWAR,Indian National Congress,84086,715,84801,51.37,49
4,YOGESH GAUTAM,Jannayak Janta Party,730,5,735,0.45,49
5,RANBIR SINGH LOHAN,Aam Aadmi Party,1050,7,1057,0.64,49
6,KRISHAN MAJRA,Mission Ekta Party,176,0,176,0.11,49
7,BHAI SATISH MASUDPUR,Aam Aadmi Parivartan Party,21,1,22,0.01,49
8,AJAY CHAUDHARY,Independent,31,0,31,0.02,49
9,JAIBIR S/O CHANDER BHAN,Independent,18,1,19,0.01,49
10,JAIBIR ALIAS JAI VIR,Independent,26,0,26,0.02,49
11,JASSI JASBIR S/O BANI SINGH,Independent,177,2,179,0.11,49
12,DHARAMVIR SAROWA,Independent,278,1,279,0.17,49
13,RAVI KUMAR,Independent,240,1,241,0.15,49
14,SANDEEP KUMAR,Independent,113,0,113,0.07,49
15,NOTA,None of the Above,547,3,550,0.33,49
1,RAVINDER KUMAR,Bahujan Samaj Party,2158,24,2182,1.53,50
2,RAJENDER SINGH,Aam Aadmi Party,2325,8,2333,1.64,50
3,RAHUL MAKKAR,Indian National Congress,56626,600,57226,40.22,50
4,VINOD BHAYANA,Bharatiya Janata Party,78274,412,78686,55.3,50
5,SHAMSHER SINGH,Jannayak Janta Party,512,4,516,0.36,50
6,VEERBHAN,Aam Aadmi Parivartan Party,70,2,72,0.05,50
7,AMARJEET,Independent,162,1,163,0.11,50
8,KASHMIRI LAL GROVER,Independent,103,0,103,0.07,50
9,JAI PARKASH,Independent,21,2,23,0.02,50
10,NAVIN,Independent,69,0,69,0.05,50
11,ROHIT,Independent,176,0,176,0.12,50
12,SUMAN KUMAR,Independent,181,1,182,0.13,50
13,HARISH VERMA,Independent,180,0,180,0.13,50
14,NOTA,None of the Above,369,5,374,0.26,50
1,ANANT RAM,Jannayak Janta Party,477,4,481,0.34,51
2,PROF. CHHATTAR PAL SINGH,Aam Aadmi Party,2521,22,2543,1.82,51
3,RANBIR GANGWA,Bharatiya Janata Party,66546,297,66843,47.72,51
4,RAMNIWAS GHORELA,Indian National Congress,39376,525,39901,28.48,51
5,SANJANA SATROAD,Indian National Lok Dal,28936,119,29055,20.74,51
6,RAJIV KHATAK,Jan Sewak Kranti Party,355,0,355,0.25,51
7,BABA DARSHAN GIRI,Independent,179,1,180,0.13,51
8,RENU DALJEET SINGH,Independent,217,0,217,0.15,51
9,SUMIT BLODA,Independent,82,0,82,0.06,51
10,NOTA,None of the Above,428,2,430,0.31,51
1,DR. KAMAL GUPTA,Bharatiya Janata Party,17297,88,17385,15.45,52
2,RAVINDER RAVI AHUJA,Jannayak Janta Party,439,0,439,0.39,52
3,RAM NIWAS RARA,Indian National Congress,30002,288,30290,26.93,52
4,SHYAM LAL,Indian National Lok Dal,533,3,536,0.48,52
5,SANJAY SATRODIA,Aam Aadmi Party,1997,4,2001,1.78,52
6,NAND KISHOR CHAWLA,Sarva Jan Smaj Party (Nand Kishore Chawla),168,0,168,0.15,52
7,SUNIL,Haryana Lokhit Party,47,0,47,0.04,52
8,AJAY SAINI,Independent,40,0,40,0.04,52
9,ANIL KUMAR S/O CHARANJIT LAL,Independent,124,0,124,0.11,52
10,ANIL KUMAR S/O JAGDISH CHANDER SHARMA,Independent,317,0,317,0.28,52
11,ANIL MAHLA,Independent,132,0,132,0.12,52
12,AMIT GROVER,Independent,2008,6,2014,1.79,52
13,GAUTAM SARDANA,Independent,6804,27,6831,6.07,52
14,TARUN JAIN,Independent,1130,5,1135,1.01,52
15,DINESH KUMAR SAINI,Independent,62,0,62,0.06,52
16,PARVEEN KUMAR,Independent,138,0,138,0.12,52
17,PRASHANT YADAV,Independent,218,0,218,0.19,52
18,MAHENDER,Independent,64,0,64,0.06,52
19,RAJENDER,Independent,343,0,343,0.3,52
20,SAVITRI JINDAL,Independent,49036,195,49231,43.76,52
21,SUNIL BANSAL,Independent,558,0,558,0.5,52
22,NOTA,None of the Above,415,6,421,0.37,52
1,ANIL MAAN,Indian National Congress,53547,639,54186,41.83,53
2,UMESH SHARMA,Aam Aadmi Party,1186,7,1193,0.92,53
3,RANDHIR PANIHAR,Bharatiya Janata Party,65890,440,66330,51.2,53
4,VIRENDER CHAUDHARY,Jannayak Janta Party,3878,13,3891,3,53
5,SARWAN KUMAR VERMA,Bahujan Samaj Party,2593,18,2611,2.02,53
6,RAJ KUMAR,Rashtravadi Bharat Party,33,1,34,0.03,53
7,ANIL KUMAR,Independent,53,0,53,0.04,53
8,ATAM PARKASH,Independent,23,0,23,0.02,53
9,JAI PRAKASH,Independent,105,1,106,0.08,53
10,PARDUMAN JOSHILA,Independent,141,2,143,0.11,53
11,MAHABIR PRASAD,Independent,201,0,201,0.16,53
12,RAVINDER MANGALI,Independent,171,2,173,0.13,53
13,RAJENDER SINGH,Independent,94,1,95,0.07,53
14,NOTA,None of the Above,502,5,507,0.39,53
1,ALKA ARYA,Jannayak Janta Party,819,12,831,0.5,54
2,GEETA BALA,Aam Aadmi Party,792,14,806,0.49,54
3,JAI PARKASH DALAL,Bharatiya Janata Party,79903,641,80544,48.49,54
4,BHOOP SINGH SHEORAN,Indian National Lok Dal,1183,8,1191,0.72,54
5,RAJBIR FARTIA,Indian National Congress,80530,806,81336,48.96,54
6,AMAR SINGH,Independent,299,0,299,0.18,54
7,KRISHAN KUMAR,Independent,39,0,39,0.02,54
8,RAJBIR S/O BEGRAJ,Independent,68,1,69,0.04,54
9,RAJBIR S/O BHARAT SINGH,Independent,35,0,35,0.02,54
10,RAJBIR S/O MOOLA RAM,Independent,115,0,115,0.07,54
11,SANJAY,Independent,188,0,188,0.11,54
12,SANDEEP SANJAY BALHARA,Independent,319,3,322,0.19,54
13,SAJJAN BHARDWAJ,Independent,80,1,81,0.05,54
14,NOTA,None of the Above,258,1,259,0.16,54
1,UMED SINGH,Bharatiya Janata Party,58605,710,59315,41.17,55
2,YASHVIR,Jannayak Janta Party,1304,17,1321,0.92,55
3,RAKESH CHANDWAS,Aam Aadmi Party,1199,22,1221,0.85,55
4,VIJAY KUMAR,Indian National Lok Dal,1948,19,1967,1.37,55
5,SOMVIR SINGH,Indian National Congress,50809,921,51730,35.9,55
6,MAHENDER JEVALI,Bhartiya Kisan Party,145,5,150,0.1,55
7,AJIT,Independent,512,0,512,0.36,55
8,ASHOK,Independent,17,0,17,0.01,55
9,CHITAR SINGH,Independent,38,3,41,0.03,55
10,JITENDER SINGH SHEORAIN,Independent,86,2,88,0.06,55
11,DINESH KUMAR,Independent,68,1,69,0.05,55
12,VIKASH,Independent,96,0,96,0.07,55
13,VIDY NAND,Independent,68,3,71,0.05,55
14,SANDEEP,Independent,195,2,197,0.14,55
15,SOMVEER GHASOLA,Independent,26570,160,26730,18.55,55
16,NOTA,None of the Above,546,6,552,0.38,55
1,ANAND SHEORAN,Bahujan Samaj Party,1024,12,1036,0.73,56
2,DHAN RAJ SINGH,Aam Aadmi Party,1305,34,1339,0.94,56
3,MANISHA SANGWAN,Indian National Congress,62625,986,63611,44.7,56
4,RAJDEEP SINGH,Jannayak Janta Party,1884,33,1917,1.35,56
5,SUNIL SATPAL SANGWAN,Bharatiya Janata Party,64935,633,65568,46.08,56
6,RAJPAL,Loktanter Suraksha Party,197,0,197,0.14,56
7,VIKRAM SHARMA,Rashtrawadi Janlok Party (Satya),96,2,98,0.07,56
8,AJIT SINGH,Independent,3328,41,3369,2.37,56
9,ANIL KUMAR,Independent,47,0,47,0.03,56
10,ARCHANA,Independent,43,3,46,0.03,56
11,NAVEEN YOGI,Independent,316,3,319,0.22,56
12,MANJEET,Independent,109,0,109,0.08,56
13,RAMSHARAN PHOGAT,Independent,28,1,29,0.02,56
14,LALIT KUMAR,Independent,241,4,245,0.17,56
15,SANJAY CHHAPARIA,Independent,3685,28,3713,2.61,56
16,SATENDER SINGH,Independent,123,2,125,0.09,56
17,SUNIL KUMAR,Independent,69,1,70,0.05,56
18,HEMANT,Independent,33,1,34,0.02,56
19,NOTA,None of the Above,425,7,432,0.3,56
1,INDU,Aam Aadmi Party,17435,138,17573,12.1,57
2,OM PRAKASH,Communist Party of India  (Marxist),33775,598,34373,23.66,57
3,KARAMBIR YADAV,Indian National Lok Dal,1017,29,1046,0.72,57
4,GHANSHYAM SARAF,Bharatiya Janata Party,66508,579,67087,46.19,57
5,PAWAN FOUJI,Rashtriya Bhagidari Samaj Party,1318,21,1339,0.92,57
6,COMRADE RAJ KUMAR,Socialist Unity Centre Of India (COMMUNIST),611,12,623,0.43,57
7,ABHIJEET LAL SINGH,Independent,15737,73,15810,10.88,57
8,ANAND KUMAR,Independent,88,1,89,0.06,57
9,JAGAT SINGH,Independent,62,0,62,0.04,57
10,JOGENDER,Independent,83,1,84,0.06,57
11,PANKAJ TAYAL,Independent,56,1,57,0.04,57
12,DR. PAWAN KUMAR SHARMA,Independent,217,1,218,0.15,57
13,PRIYA ASIJA,Independent,3638,22,3660,2.52,57
14,MAHABIR BOHRA,Independent,94,3,97,0.07,57
15,RAJEEV,Independent,1812,13,1825,1.26,57
16,RAM AVTAR SHARMA,Independent,252,0,252,0.17,57
17,RAM KUMAR,Independent,281,0,281,0.19,57
18,SATISH KUMAR,Independent,312,2,314,0.22,57
19,NOTA,None of the Above,453,11,464,0.32,57
1,ANIRUDH CHAUDHARY,Indian National Congress,61417,740,62157,38.68,58
2,OM SINGH,Bahujan Samaj Party,1623,22,1645,1.02,58
3,DALJEET SINGH,Aam Aadmi Party,513,6,519,0.32,58
4,RAJESH BHARDWAJ,Jannayak Janta Party,2157,18,2175,1.35,58
5,SHRUTI CHOUDHRY,Bharatiya Janata Party,75728,686,76414,47.55,58
6,PARDEEP,Bahujan Mukti Party,189,1,190,0.12,58
7,BABA BALWAN NATH,Peoples Party of India (Democratic),161,1,162,0.1,58
8,VIJENDER SINGH,Rashtrawadi Janlok Party (Satya),59,0,59,0.04,58
9,SUBHASH CHANDER,Rashtriya Janhit Vikas Party,199,1,200,0.12,58
10,ANIL KUMAR,Independent,49,0,49,0.03,58
11,KRISHAN KUMAR,Independent,143,0,143,0.09,58
12,PUSHPA DEVI,Independent,317,1,318,0.2,58
13,BALWAN SINGH,Independent,86,2,88,0.05,58
14,RAJNISH KUMAR,Independent,224,0,224,0.14,58
15,SHASHI RANJAN PARMAR,Independent,15776,83,15859,9.87,58
16,NOTA,None of the Above,486,4,490,0.3,58
1,KAPOOR SINGH,Bharatiya Janata Party,79433,644,80077,52.21,59
2,GUDDI LANGYAN,Jannayak Janta Party,986,11,997,0.65,59
3,DHARAMBIR,Aam Aadmi Party,626,20,646,0.42,59
4,PRADEEP NARWAL,Indian National Congress,57559,739,58298,38.01,59
5,SANDEEP SINGH JANAGAL,Bahujan Samaj Party,1116,12,1128,0.74,59
6,MANJU DHANAK,Aam Aadmi Parivartan Party,88,5,93,0.06,59
7,VIKAS,Rashtrawadi Janlok Party (Satya),60,0,60,0.04,59
8,RAMESH KUMAR,Independent,131,0,131,0.09,59
9,RAVITA SATBIR RATERA,Independent,123,5,128,0.08,59
10,MASTER SATBIR RATERA,Independent,11221,66,11287,7.36,59
11,NOTA,None of the Above,513,11,524,0.34,59
1,DEEPAK HOODA,Bharatiya Janata Party,8767,162,8929,5.97,60
2,BALRAM DANGI,Indian National Congress,56079,786,56865,38.04,60
3,VIKASH NEHRA,Aam Aadmi Party,8564,46,8610,5.76,60
4,HAWA SINGH,Bahujan Samaj Party,1423,17,1440,0.96,60
5,KRISHAN,Peoples Party of India (Democratic),94,0,94,0.06,60
6,KRISHAN KUMAR,Aam Aadmi Parivartan Party,223,0,223,0.15,60
7,BALRAJ KUNDU,Haryana Jan Sevak Party,38605,200,38805,25.96,60
8,VISHESH BAMEL,Bharatiya Asha Party,318,1,319,0.21,60
9,KRISHAN,Independent,63,1,64,0.04,60
10,JALKARAN BALHARA,Independent,132,0,132,0.09,60
11,DAYA KRISHAN,Independent,52,0,52,0.03,60
12,NARESH,Independent,236,0,236,0.16,60
13,NEERAJ,Independent,67,0,67,0.04,60
14,BALBIR SINGH,Independent,3382,17,3399,2.27,60
15,MAHENDER SINGH,Independent,156,0,156,0.1,60
16,MUKESH KUMAR,Independent,267,0,267,0.18,60
17,RANBIR SINGH,Independent,132,0,132,0.09,60
18,RADHA AHLAWAT,Independent,29112,99,29211,19.54,60
19,VIKASH,Independent,141,0,141,0.09,60
20,NOTA,None of the Above,346,7,353,0.24,60
1,KRISHAN,Indian National Lok Dal,1483,13,1496,1,61
2,PARVEEN,Aam Aadmi Party,883,12,895,0.6,61
3,BHUPINDER SINGH HOODA,Indian National Congress,107520,1019,108539,72.72,61
4,MANJU,Bharatiya Janata Party,36894,180,37074,24.84,61
5,SUSHILA DEVI,Jannayak Janta Party,477,3,480,0.32,61
6,AMIT HOODA,Independent,72,0,72,0.05,61
7,BIJENDER SINGH,Independent,155,0,155,0.1,61
8,MUKESH,Independent,148,0,148,0.1,61
9,SANJAY,Independent,75,1,76,0.05,61
10,NOTA,None of the Above,310,3,313,0.21,61
1,JITENDER BALHARA,Jannayak Janta Party,268,0,268,0.22,62
2,DILOUR MEHRA,Indian National Lok Dal,423,5,428,0.35,62
3,BIJENDER HOODA,Aam Aadmi Party,1180,8,1188,0.98,62
4,BHARAT BHUSHAN BATRA,Indian National Congress,58830,589,59419,49.25,62
5,MANISH KUMAR GROVER,Bharatiya Janata Party,57805,273,58078,48.14,62
6,PARVEEN KUMAR,Yuga Thulasi Party,171,1,172,0.14,62
7,MANISHA MOKHRA,Socialist Unity Centre Of India (COMMUNIST),58,0,58,0.05,62
8,MAHENDER BAGRI,Mission Ekta Party,138,0,138,0.11,62
9,ASHWANI MALIK,Independent,38,0,38,0.03,62
10,ANAND KUMAR,Independent,30,0,30,0.02,62
11,NAVDEEP SINGH  RAMAN,Independent,27,0,27,0.02,62
12,BISHAMBER KUMAR,Independent,98,0,98,0.08,62
13,BHARAT BHUSHAN,Independent,86,1,87,0.07,62
14,YASHPAL,Independent,32,0,32,0.03,62
15,SURENDER KUMAR,Independent,18,0,18,0.01,62
16,NOTA,None of the Above,564,5,569,0.47,62
1,NARESH BAGRI,Aam Aadmi Party,1053,9,1062,0.74,63
2,POONAM NIGANA,Bahujan Samaj Party,1382,12,1394,0.97,63
3,MAHENDER SUNDANA,Jannayak Janta Party,1181,10,1191,0.83,63
4,RENU DABLA,Bharatiya Janata Party,56861,255,57116,39.87,63
5,SHAKUNTLA KHATAK,Indian National Congress,68817,531,69348,48.41,63
6,BABA ISHWAR NATH,Aam Aadmi Parivartan Party,219,2,221,0.15,63
7,OM PARKASH,Peoples Party of India (Democratic),119,0,119,0.08,63
8,MANJEET,Haryana Jan Sevak Party,236,1,237,0.17,63
9,RANBIR,Nationalist Congress Party,51,5,56,0.04,63
10,DEEPAK SINGH,Independent,331,2,333,0.23,63
11,PREM PRADHAN,Independent,11342,73,11415,7.97,63
12,VINOD,Independent,115,0,115,0.08,63
13,SNEH ARYA,Independent,225,0,225,0.16,63
14,NOTA,None of the Above,425,4,429,0.3,63
1,KULDEEP SINGH CHHIKARA,Aam Aadmi Party,959,7,966,0.61,64
2,DINESH KAUSHIK,Bharatiya Janata Party,31064,128,31192,19.61,64
3,RAJINDER SINGH JOON,Indian National Congress,28735,220,28955,18.2,64
4,SHEELA NAFE SINGH RATHEE,Indian National Lok Dal,17475,36,17511,11.01,64
5,ARUN GOYAL,Independent,81,0,81,0.05,64
6,CHESTA,Independent,66,0,66,0.04,64
7,PARVEEN KUMAR,Independent,93,1,94,0.06,64
8,MAHENDER,Independent,254,1,255,0.16,64
9,RAMESH DALAL,Independent,4726,19,4745,2.98,64
10,RAJESH KUMAR S/O CHATTAR SINGH,Independent,512,0,512,0.32,64
11,RAJESH KUMAR S/O RAMDIYA,Independent,487,0,487,0.31,64
12,RAJESH JOON,Independent,73087,104,73191,46,64
13,ROHIT KUMAR,Independent,292,2,294,0.18,64
14,SUNITA,Independent,187,0,187,0.12,64
15,NOTA,None of the Above,563,1,564,0.35,64
1,OMPRAKASH DHANKAR,Bharatiya Janata Party,51052,288,51340,38.81,65
2,KULDEEP VATS,Indian National Congress,67555,605,68160,51.52,65
3,KRISHAN KUMAR,Jannayak Janta Party,517,2,519,0.39,65
4,HARPAL SINGH,Aam Aadmi Party,595,6,601,0.45,65
5,AJIT GULIA JEETE,Independent,10799,21,10820,8.18,65
6,AMIT KUMAR,Independent,123,1,124,0.09,65
7,POONAM,Independent,40,3,43,0.03,65
8,VIRENDER SINGH BILU,Independent,79,2,81,0.06,65
9,SANDEEP,Independent,200,1,201,0.15,65
10,NOTA,None of the Above,407,4,411,0.31,65
1,KAPTAN BIRDHANA,Bharatiya Janata Party,52346,444,52790,42.7,66
2,GEETA BHUKKAL,Indian National Congress,65325,1020,66345,53.66,66
3,DHARAMBIR SINGH,Bahujan Samaj Party,808,8,816,0.66,66
4,NASEEB SONU,Jannayak Janta Party,1826,10,1836,1.48,66
5,MAHINDER DAHIYA,Aam Aadmi Party,730,8,738,0.6,66
6,JAIDEEP,Republican Party of India (A),193,0,193,0.16,66
7,NARENDER SINGH FAUJI,Independent,135,8,143,0.12,66
8,RAJAL,Independent,80,2,82,0.07,66
9,SANJAY,Independent,28,1,29,0.02,66
10,SATBIR CHUMBAK ADVOCATE,Independent,67,0,67,0.05,66
11,SUNIL KUMAR,Independent,153,0,153,0.12,66
12,NOTA,None of the Above,444,5,449,0.36,66
1,PERMOD,Indian National Lok Dal,2157,14,2171,1.82,67
2,RAGHUVIR SINGH KADIAN,Indian National Congress,59956,674,60630,50.96,67
3,SANJAY KUMAR,Bharatiya Janata Party,24969,191,25160,21.15,67
4,SUNIL,Jannayak Janta Party,1108,11,1119,0.94,67
5,SONU,Aam Aadmi Party,1671,11,1682,1.41,67
6,AMIT KUMAR,Independent,24546,80,24626,20.7,67
7,INDERJEET SUHAG,Independent,2154,8,2162,1.82,67
8,GOWARDHAN SINGH,Independent,1125,2,1127,0.95,67
9,NOTA,None of the Above,282,7,289,0.24,67
1,ATTAR LAL,Bahujan Samaj Party,54274,378,54652,37.63,68
2,ANITA YADAV,Indian National Congress,29474,563,30037,20.68,68
3,AAYUSHI ABHIMANYU RAO,Jannayak Janta Party,1728,20,1748,1.2,68
4,ARTI SINGH RAO,Bharatiya Janata Party,56774,963,57737,39.75,68
5,SUNEEL RAO,Aam Aadmi Party,209,11,220,0.15,68
6,COMRADE OM PARKASH,Socialist Unity Centre Of India (COMMUNIST),183,2,185,0.13,68
7,JOGENDER FOUJI,Independent,154,13,167,0.11,68
8,SADHNA,Independent,71,5,76,0.05,68
9,NOTA,None of the Above,408,10,418,0.29,68
1,KANWAR SINGH,Bharatiya Janata Party,62000,1036,63036,40.56,69
2,RAO DAN SINGH,Indian National Congress,59257,1131,60388,38.86,69
3,DR. MANISH YADAV,Aam Aadmi Party,1702,38,1740,1.12,69
4,SURENDER KAUSHIK,Indian National Lok Dal,3900,33,3933,2.53,69
5,RAKESH SINGH,Rashtrawadi Janlok Party (Satya),845,5,850,0.55,69
6,VISHNU YADAV,Bharatiya Asha Party,137,5,142,0.09,69
7,SHASHI KUMAR,Aazad Samaj Party (Kanshi Ram),455,9,464,0.3,69
8,NARENDER KUMAR,Independent,45,0,45,0.03,69
9,PUSHKAR RAJ GUPTA,Independent,70,1,71,0.05,69
10,BALWAN FAUJI,Independent,1652,43,1695,1.09,69
11,DR. BHUP SINGH YADAV,Independent,1471,17,1488,0.96,69
12,VED PRAKASH,Independent,294,0,294,0.19,69
13,SANDEEP SINGH,Independent,20651,183,20834,13.41,69
14,NOTA,None of the Above,417,4,421,0.27,69
1,OM PRAKASH YADAV,Bharatiya Janata Party,56847,788,57635,54.08,70
2,NAR SINGH,Indian National Lok Dal,437,11,448,0.42,70
3,RAO NARENDER SINGH,Indian National Congress,39746,718,40464,37.97,70
4,RAVINDER SINGH MATRU,Aam Aadmi Party,6148,40,6188,5.81,70
5,SURESH KUMAR SAINI,Jannayak Janta Party,436,4,440,0.41,70
6,TEJ PRAKASH,Bhartiya Shakti Chetna Party,113,1,114,0.11,70
7,VIKAS,Right to Recall Party,56,0,56,0.05,70
8,UMAKANT,Independent,280,6,286,0.27,70
9,KRISHAN KUMAR,Independent,205,6,211,0.2,70
10,KRISHAN KUMAR,Independent,144,4,148,0.14,70
11,SABHARAM,Independent,51,0,51,0.05,70
12,NOTA,None of the Above,524,11,535,0.5,70
1,DR. ABHE SINGH YADAV,Bharatiya Janata Party,54209,850,55059,46.47,71
2,RAO OM PRAKASH ENGINEER,Jannayak Janta Party,568,8,576,0.49,71
3,MANJU CHOUDHARY,Indian National Congress,61237,752,61989,52.32,71
4,SAGAR CHAUHAN,Veer Lakshya Party,353,0,353,0.3,71
5,KARTAR SINGH,Independent,101,9,110,0.09,71
6,NOTA,None of the Above,382,4,386,0.33,71
1,DR. KRISHAN KUMAR,Bharatiya Janata Party,86119,739,86858,55.28,72
2,JAWAHAR LAL,Aam Aadmi Party,563,18,581,0.37,72
3,DR. M.L. RANGA,Indian National Congress,66228,619,66847,42.54,72
4,SAMPAT RAM DAHANWAL,Indian National Lok Dal,1427,13,1440,0.92,72
5,DR. LEKHRAM MEHRA,Loktanter Suraksha Party,107,0,107,0.07,72
6,INDER SINGH,Independent,64,3,67,0.04,72
7,BALJEET,Independent,162,3,165,0.11,72
8,MANGAT RAM,Independent,165,1,166,0.11,72
9,RAJ NARAYAN,Independent,167,3,170,0.11,72
10,SUNIL KUMAR,Independent,249,2,251,0.16,72
11,NOTA,None of the Above,475,8,483,0.31,72
1,ANIL YADAV,Bharatiya Janata Party,90888,1297,92185,51.76,73
2,JAGDISH YADAV,Indian National Congress,73744,1232,74976,42.1,73
3,RAJ KUMAR,Bahujan Samaj Party,551,12,563,0.32,73
4,LAVINDER SINGH,Jannayak Janta Party,306,4,310,0.17,73
5,TEJPAL YADAV KOSLI,Buland Bharat Party,76,4,80,0.04,73
6,NAVAL SINGH,Right to Recall Party,54,1,55,0.03,73
7,BHAGIRATH DABLA BOHTWAS,Bhartiya Janraj Party,35,6,41,0.02,73
8,COMRADE RAMKUMAR NIMOTH,Socialist Unity Centre Of India (COMMUNIST),265,8,273,0.15,73
9,SATYAVIR SINGH AMBEDKAR,Republican Party of India,223,7,230,0.13,73
10,ANIL KUMAR,Independent,50,6,56,0.03,73
11,ARTI RAO,Independent,68,20,88,0.05,73
12,INDERJEET,Independent,29,2,31,0.02,73
13,KARAMJEET,Independent,60,8,68,0.04,73
14,MANOJ KOSLIA,Independent,7196,106,7302,4.1,73
15,MUKESH KUMAR,Independent,190,1,191,0.11,73
16,SANTOSH,Independent,292,1,293,0.16,73
17,HARIOM YADAV KOSLIA,Independent,650,4,654,0.37,73
18,NOTA,None of the Above,695,20,715,0.4,73
1,CHIRANJEEV RAO,Indian National Congress,54365,613,54978,32.79,74
2,LAXMAN SINGH YADAV,Bharatiya Janata Party,83236,511,83747,49.95,74
3,SATISH YADAV,Aam Aadmi Party,18365,62,18427,10.99,74
4,SOMANY VIJAY,Bahujan Samaj Party,751,6,757,0.45,74
5,KARTAR SINGH THEKEDAR,Peoples Party of India (Democratic),153,1,154,0.09,74
6,MOKI DEVI,Aazad Samaj Party (Kanshi Ram),204,2,206,0.12,74
7,RANBIR SINGH,Rashtriya Lokswaraj Party,174,0,174,0.1,74
8,OMDUTT YADAV,Independent,54,0,54,0.03,74
9,RAO JITENDER KUMAR,Independent,84,2,86,0.05,74
10,PRASHANT SUNNY YADAV,Independent,7731,56,7787,4.64,74
11,SANJAY SHARMA,Independent,276,2,278,0.17,74
12,SHISHUPAL,Independent,350,4,354,0.21,74
13,NOTA,None of the Above,661,4,665,0.4,74
1,AMARNATH J. E.,Jannayak Janta Party,952,11,963,0.61,75
2,PEARL CHOUDHARY,Indian National Congress,51748,241,51989,32.93,75
3,PAWAN KUMAR BHORA,Indian National Lok Dal,3194,20,3214,2.04,75
4,PARDEEP JATAULI,Aam Aadmi Party,1855,19,1874,1.19,75
5,BIMLA CHAUDHARY,Bharatiya Janata Party,98045,474,98519,62.4,75
6,GURDASS,Independent,378,3,381,0.24,75
7,SATYAVIR JANAULA,Independent,280,5,285,0.18,75
8,NOTA,None of the Above,662,6,668,0.42,75
1,JOGINDER SINGH,Bahujan Samaj Party,1561,0,1561,0.55,76
2,RAO NARBIR SINGH,Bharatiya Janata Party,145248,255,145503,51.54,76
3,BIR SINGH BIRU SARPANCH,Aam Aadmi Party,12934,9,12943,4.59,76
4,VARDHAN YADAV,Indian National Congress,84636,162,84798,30.04,76
5,SURENDER KUMAR,Jannayak Janta Party,441,0,441,0.16,76
6,CHANDERPAL,Bhartiya Shakti Chetna Party,155,0,155,0.05,76
7,COMRADE BALWAN SINGH,Socialist Unity Centre Of India (COMMUNIST),3038,0,3038,1.08,76
8,KUMUDNI RAKESH DAULTABAD,Independent,30833,52,30885,10.94,76
9,RAVINDER YADAV,Independent,403,0,403,0.14,76
10,RAKESH BHARDWAJ,Independent,159,0,159,0.06,76
11,RAMBHAGAT YADAV,Independent,192,0,192,0.07,76
12,VINOD KUMAR,Independent,179,0,179,0.06,76
13,SATISH,Independent,225,0,225,0.08,76
14,NOTA,None of the Above,1802,1,1803,0.64,76
1,ASHOK JANGRA,Jannayak Janta Party,219,1,220,0.1,77
2,GAURAV BHATI,Indian National Lok Dal,395,1,396,0.17,77
3,DR. NISHANT ANAND,Aam Aadmi Party,2169,8,2177,0.95,77
4,MUKESH SHARMA,Bharatiya Janata Party,122301,314,122615,53.29,77
5,MOHIT GROVER,Indian National Congress,46784,163,46947,20.4,77
6,ANKIT ALAGH JAN SEWAK,Jan Sewak Kranti Party,516,1,517,0.22,77
7,JAWAHAR LAL,Nehru Janhit Congress,67,0,67,0.03,77
8,RAJESH SHEORAN,Bhartiya Kisan Party,51,0,51,0.02,77
9,AKSHAT GAIT,Independent,41,1,42,0.02,77
10,NARENDER KUMAR,Independent,154,0,154,0.07,77
11,NARESH KUMAR BATRA,Independent,261,0,261,0.11,77
12,NAVEEN GOYAL,Independent,54512,58,54570,23.72,77
13,MAHABIR SINGH,Independent,213,1,214,0.09,77
14,MUKESH SHARMA,Independent,246,0,246,0.11,77
15,SANJAY LAL,Independent,221,0,221,0.1,77
16,SUNIL,Independent,260,0,260,0.11,77
17,SOHAN LAL SHARMA,Independent,71,0,71,0.03,77
18,NOTA,None of the Above,1070,5,1075,0.47,77
1,TEJPAL TANWAR,Bharatiya Janata Party,60994,249,61243,30.09,78
2,DHARMENDRA KHATANA,Aam Aadmi Party,2852,5,2857,1.4,78
3,ROHTAS SINGH,Indian National Congress,49177,189,49366,24.25,78
4,SUNDER BHADANA,Bahujan Samaj Party,15454,22,15476,7.6,78
5,ATAULLAH KHAN,Loktanter Suraksha Party,506,2,508,0.25,78
6,VINESH GUJJAR GHATA,Aazad Samaj Party (Kanshi Ram),2037,3,2040,1,78
7,KALYAN SINGH,Independent,21703,51,21754,10.69,78
8,JAVED AHMED,Independent,49171,39,49210,24.17,78
9,DAYARAM,Independent,256,0,256,0.13,78
10,SUBHASH CHAND,Independent,252,0,252,0.12,78
11,NOTA,None of the Above,599,1,600,0.29,78
1,AFTAB AHMED,Indian National Congress,91697,136,91833,59.26,79
2,TAHIR HUSSAIN,Indian National Lok Dal,44826,44,44870,28.96,79
3,BIRENDER,Jannayak Janta Party,1565,5,1570,1.01,79
4,RABIA KIDWAI,Aam Aadmi Party,212,10,222,0.14,79
5,SANJAY SINGH,Bharatiya Janata Party,15810,92,15902,10.26,79
6,ANWAR,Bharat Jodo Party,190,0,190,0.12,79
7,NOTA,None of the Above,367,2,369,0.24,79
1,JAAN MOHAMMAD,Jannayak Janta Party,719,1,720,0.4,80
2,NASEEM AHMED,Bharatiya Janata Party,31958,98,32056,17.69,80
3,MAMMAN KHAN,Indian National Congress,130286,211,130497,72.03,80
4,MOHAMMAD HABIB,Indian National Lok Dal,15625,13,15638,8.63,80
5,WASEEM ZAFFER,Aam Aadmi Party,233,1,234,0.13,80
6,NARENDER KUMAR,Independent,256,1,257,0.14,80
7,MUMTAJ AHMED,Independent,1139,3,1142,0.63,80
8,MOHD. HASHIM,Independent,183,0,183,0.1,80
9,NOTA,None of the Above,438,1,439,0.24,80
1,DAYA WATI,Indian National Lok Dal,289,0,289,0.2,81
2,NAYAB HUSSAIN,Aam Aadmi Party,852,2,854,0.58,81
3,MOHAMMAD ILYAS,Indian National Congress,85173,127,85300,58.31,81
4,MOHD AIZAZ KHAN,Bharatiya Janata Party,5055,17,5072,3.47,81
5,ATAULLAH,Aazad Samaj Party (Kanshi Ram),829,0,829,0.57,81
6,RAHISH KHAN,Independent,53327,57,53384,36.49,81
7,SAJID,Independent,204,2,206,0.14,81
8,NOTA,None of the Above,345,0,345,0.24,81
1,TAYUB HUSAIN URF NAZIR AHMED,Indian National Lok Dal,37772,71,37843,20.1,82
2,MANOJ KUMAR,Bharatiya Janata Party,47106,405,47511,25.24,82
3,MOHD ISRAIL,Indian National Congress,79638,269,79907,42.45,82
4,RAVINDER KUMAR,Jannayak Janta Party,5673,26,5699,3.03,82
5,RAJENDRA SINGH RAWAT,Aam Aadmi Party,1031,24,1055,0.56,82
6,KEHAR SINGH,Independent,4915,30,4945,2.63,82
7,DHARMENDRA TEWATIA,Independent,10460,34,10494,5.57,82
8,PRADEEP KUMAR,Independent,352,0,352,0.19,82
9,NOTA,None of the Above,430,2,432,0.23,82
1,UDAI BHAN,Indian National Congress,66065,205,66270,46.95,83
2,MANOHAR,Aam Aadmi Party,284,8,292,0.21,83
3,SATVEER,Jannayak Janta Party,273,8,281,0.2,83
4,SUNIL KUMAR,Indian National Lok Dal,1836,2,1838,1.3,83
5,HARINDER SINGH,Bharatiya Janata Party,68697,168,68865,48.79,83
6,USHMA DEVI,Independent,193,1,194,0.14,83
7,KULDEEP KUMAR,Independent,55,0,55,0.04,83
8,NAVEEN ROHILA,Independent,2076,1,2077,1.47,83
9,NEERAJ SOUROT,Independent,171,1,172,0.12,83
10,YASHVEER,Independent,100,0,100,0.07,83
11,RAJNI,Independent,63,0,63,0.04,83
12,SUNITA SOROUT,Independent,545,1,546,0.39,83
13,NOTA,None of the Above,391,2,393,0.28,83
1,ABHISHEK DESHWAL,Bahujan Samaj Party,2536,4,2540,1.32,84
2,KARAN SINGH DALAL,Indian National Congress,75126,387,75513,39.15,84
3,GAURAV GAUTAM,Bharatiya Janata Party,108795,323,109118,56.57,84
4,DHARMENDER SINGH,Aam Aadmi Party,629,9,638,0.33,84
5,GOPAL DUTT,Samata Party,68,0,68,0.04,84
6,PANCH LAL PRASAD,Bharat Jan Jagran Dal,36,3,39,0.02,84
7,RAMPAL,Bahujan Janata Dal (Khodawal),75,3,78,0.04,84
8,SATBIR SINGH,Akhil Bharatiya Socialist Party,95,0,95,0.05,84
9,HARIT KUMAR,Aazad Samaj Party (Kanshi Ram),2568,10,2578,1.34,84
10,GIRRAJ,Independent,124,0,124,0.06,84
11,MAMTA SOLANKI,Independent,141,0,141,0.07,84
12,SHIV DUTT,Independent,1116,0,1116,0.58,84
13,SUNIL KUMAR,Independent,325,1,326,0.17,84
14,NOTA,None of the Above,503,3,506,0.26,84
1,KAUSHAL TATARPUR,Aam Aadmi Party,703,3,706,0.42,85
2,TEK CHAND SHARMA,Bharatiya Janata Party,49579,142,49721,29.74,85
3,RAGHUBIR TEWATIA,Indian National Congress,69958,304,70262,42.02,85
4,SURENDER VASHISHT,Bahujan Samaj Party,4402,10,4412,2.64,85
5,GIRIRAJ JATOLA,Aazad Samaj Party (Kanshi Ram),267,3,270,0.16,85
6,MUKESH,Samata Party,304,1,305,0.18,85
7,ABDUT NATH,Independent,959,2,961,0.57,85
8,JITENDER KUMAR,Independent,219,1,220,0.13,85
9,DEEPAK DAGAR,Independent,16028,27,16055,9.6,85
10,NAYANPAL RAWAT,Independent,21987,36,22023,13.17,85
11,BIJENDER SINGH ADVOCATE,Independent,709,0,709,0.42,85
12,RAHUL,Independent,596,0,596,0.36,85
13,SAMEY SINGH,Independent,284,1,285,0.17,85
14,NOTA,None of the Above,664,2,666,0.4,85
1,HAJI KARAMAT ALI,Jannayak Janta Party,8768,6,8774,4.53,86
2,NAGENDER BHADANA,Indian National Lok Dal,29519,30,29549,15.27,86
3,NEERAJ SHARMA,Indian National Congress,58686,89,58775,30.38,86
4,RAVI DAGAR,Aam Aadmi Party,1412,3,1415,0.73,86
5,SATISH KUMAR PHAGNA,Bharatiya Janata Party,91918,74,91992,47.54,86
6,DHEERAJ KUMAR,Political Team India,328,0,328,0.17,86
7,MANISH,Akhil Bhartiya Kisan Majdoor Party,193,0,193,0.1,86
8,RAM PARTAP GAUR,Rashtriya Lokswaraj Party,112,0,112,0.06,86
9,VINOD SINGH,Rashtrawadi Janlok Party (Satya),227,1,228,0.12,86
10,JITENDER KUMAR,Independent,280,0,280,0.14,86
11,RANJOT,Independent,129,0,129,0.07,86
12,RAVINDER GUPTA,Independent,217,0,217,0.11,86
13,RAJKUMAR,Independent,288,0,288,0.15,86
14,NOTA,None of the Above,1209,1,1210,0.63,86
1,OM PRAKASH VERMA,Aam Aadmi Party,1679,2,1681,1.05,87
2,DHANESH ADLAKHA,Bharatiya Janata Party,79386,90,79476,49.68,87
3,PARVINDER SINGH,Jannayak Janta Party,657,2,659,0.41,87
4,MANOJ CHOUDHARY,Bahujan Samaj Party,2493,0,2493,1.56,87
5,VIJAY PRATAP SINGH,Indian National Congress,73197,98,73295,45.81,87
6,KAMAL BALI,Bhartiya Shakti Chetna Party,371,0,371,0.23,87
7,PREM CHAND GAUR,Buland Bharat Party,228,2,230,0.14,87
8,AABID KHAN,Independent,113,0,113,0.07,87
9,BAKIL AKHTAR,Independent,157,0,157,0.1,87
10,NOTA,None of the Above,1505,4,1509,0.94,87
1,SMT. PARAG SHARMA,Indian National Congress,8627,47,8674,5.92,88
2,MOOL CHAND SHARMA,Bharatiya Janata Party,61706,100,61806,42.16,88
3,RAVINDRA FAUJDAR,Aam Aadmi Party,6625,9,6634,4.52,88
4,ATUL,Akhil Bhartiya Kisan Majdoor Party,198,1,199,0.14,88
5,ADVOCATE BRAHMA PRAKASH,Independent,326,0,326,0.22,88
6,RAO RAM KUMAR,Independent,23054,23,23077,15.74,88
7,VANDANA SINGH,Independent,784,0,784,0.53,88
8,SHARDA RATHORE,Independent,43992,84,44076,30.06,88
9,NOTA,None of the Above,1034,0,1034,0.71,88
1,NARENDER PAL SINGH BAGHEL,Indian National Lok Dal,858,1,859,0.6,89
2,PRAVESH MEHTA,Aam Aadmi Party,924,2,926,0.65,89
3,LAKHAN KUMAR SINGLA,Indian National Congress,45195,68,45263,31.63,89
4,VIPUL GOEL,Bharatiya Janata Party,93521,130,93651,65.45,89
5,ADARSH BALYAN,Independent,394,2,396,0.28,89
6,MANOJ DUREJA,Independent,158,0,158,0.11,89
7,RAKESH KAPIL DAGAR,Independent,330,1,331,0.23,89
8,VIJAY KRISHAN,Independent,478,0,478,0.33,89
9,NOTA,None of the Above,1022,3,1025,0.72,89
1,ABHASH CHANDELA,Aam Aadmi Party,5665,4,5669,2.78,90
2,TIKA RAM,Jannayak Janta Party,854,0,854,0.42,90
3,RAJESH NAGAR,Bharatiya Janata Party,94084,145,94229,46.26,90
4,ROHIT NAGAR,Indian National Congress,21599,57,21656,10.63,90
5,LAL CHAND SHARMA,Bahujan Samaj Party,3682,4,3686,1.81,90
6,RAM BAHADUR,Akhil Bhartiya Manavatavadi Party,313,0,313,0.15,90
7,SHIV NARAYAN DUBEY,Kisan Mazdoor Sangharsh Party,3977,0,3977,1.95,90
8,SOMESHWAR SINGH,Samata Party,1022,0,1022,0.5,90
9,GIRRAJ SHARMA,Independent,11802,6,11808,5.8,90
10,LALIT NAGAR S/O LATE BHARAT SINGH NAGAR,Independent,56729,99,56828,27.9,90
11,LALIT NAGAR S/O VIJAY PAL,Independent,978,3,981,0.48,90
12,SANDEEP MEHTA,Independent,533,1,534,0.26,90
13,PUNDIT SUBHASH CHANDRA DUBEY GORAKHPURI,Independent,298,0,298,0.15,90
14,NOTA,None of the Above,1855,4,1859,0.91,90
